"ADDRESS","BOROUGH","BIN","ZIP","CD","HPD_VIOLATIONS","DOB_VIOLATIONS","TOTAL_VIOLATIONS","DWELLING_UNITS","VIO_UNITS_RATIO"
"94A GREENWICH STREET","Manhattan","1001057","10006","101","16","1","17","4","4.3"
"160 CHAMBERS STREET","Manhattan","1001490","10007","101","13","0","13","4","3.3"
"13 HUDSON STREET","Manhattan","1001511","10013","101","39","2","41","4","10.3"
"111 READE STREET","Manhattan","1001586","10013","101","0","23","23","4","5.8"
"380 BROADWAY","Manhattan","1002317","10013","101","20","2","22","6","3.7"
"123 MULBERRY STREET","Manhattan","1002653","10013","102","32","0","32","6","5.3"
"47 MARKET STREET","Manhattan","1003303","10002","103","48","0","48","14","3.4"
"54 EAST BROADWAY","Manhattan","1003500","10002","103","54","13","67","8","8.4"
"105 EAST BROADWAY","Manhattan","1003535","10002","103","15","0","15","3","5"
"217 HENRY STREET","Manhattan","1003708","10002","103","19","0","19","6","3.2"
"42 CANAL STREET","Manhattan","1003802","10002","103","30","3","33","3","11"
"26 LUDLOW STREET","Manhattan","1003827","10002","103","32","0","32","10","3.2"
"36 LUDLOW STREET","Manhattan","1004020","10002","103","48","0","48","8","6"
"175 STANTON STREET","Manhattan","1004117","10002","103","65","0","65","8","8.1"
"97 CLINTON STREET","Manhattan","1004183","10002","103","94","1","95","9","10.6"
"298 EAST 3 STREET","Manhattan","1004360","10009","103","113","0","113","9","12.6"
"252 EAST 4 STREET","Manhattan","1004613","10009","103","40","0","40","12","3.3"
"129 AVENUE C","Manhattan","1004749","10009","103","27","1","28","8","3.5"
"504 EAST 6 STREET","Manhattan","1005045","10009","103","42","3","45","10","4.5"
"106 AVENUE B","Manhattan","1005095","10009","103","29","0","29","8","3.6"
"519 EAST 6 STREET","Manhattan","1005111","10009","103","31","0","31","10","3.1"
"73 ORCHARD STREET","Manhattan","1005450","10002","103","163","2","165","7","23.6"
"127 ALLEN STREET","Manhattan","1005492","10002","103","74","0","74","24","3.1"
"125 ALLEN STREET","Manhattan","1005493","10002","103","86","0","86","24","3.6"
"120 FORSYTH STREET","Manhattan","1005585","10002","103","54","2","56","18","3.1"
"135 CHRYSTIE STREET","Manhattan","1005666","10002","103","108","1","109","22","5"
"157 CHRYSTIE STREET","Manhattan","1005694","10002","103","36","0","36","6","6"
"91 EAST    7 STREET","Manhattan","1005814","10009","103","16","5","21","4","5.3"
"121 ST MARKS PLACE","Manhattan","1005882","10009","103","106","0","106","33","3.2"
"158 1 AVENUE","Manhattan","1005896","10009","103","100","7","107","11","9.7"
"219 AVENUE A","Manhattan","1006021","10009","103","41","58","99","11","9"
"107 1 AVENUE","Manhattan","1006286","10003","103","24","0","24","8","3"
"129 1 AVENUE","Manhattan","1006334","10003","103","22","3","25","8","3.1"
"331 EAST 9 STREET","Manhattan","1006422","10003","103","57","6","63","10","6.3"
"329 EAST 9 STREET","Manhattan","1006423","10003","103","18","0","18","5","3.6"
"351 EAST   12 STREET","Manhattan","1006498","10003","103","5","6","11","3","3.7"
"75 2 AVENUE","Manhattan","1006594","10003","103","15","47","62","4","15.5"
"131 2 AVENUE","Manhattan","1006677","10003","103","193","1","194","20","9.7"
"141 2 AVENUE","Manhattan","1006746","10003","103","56","6","62","20","3.1"
"115 ELIZABETH STREET","Manhattan","1006931","10013","102","31","2","33","10","3.3"
"113 ELIZABETH STREET","Manhattan","1006932","10013","102","37","2","39","10","3.9"
"375 BROOME STREET","Manhattan","1006984","10013","102","141","0","141","23","6.1"
"62 GRAND STREET","Manhattan","1007074","10013","102","13","1","14","3","4.7"
"174 ELIZABETH STREET","Manhattan","1007136","10012","102","16","0","16","4","4"
"18 R SPRING STREET","Manhattan","1007176","10012","102","23","3","26","5","5.2"
"442 BROOME STREET","Manhattan","1007254","10013","102","45","0","45","8","5.6"
"24 PRINCE STREET","Manhattan","1007481","10012","102","31","0","31","8","3.9"
"149 SPRING STREET","Manhattan","1007720","10012","102","30","8","38","7","5.4"
"262 ELIZABETH STREET","Manhattan","1007859","10012","102","33","0","33","9","3.7"
"51 EAST HOUSTON STREET","Manhattan","1007921","10012","102","25","0","25","8","3.1"
"4 BLEECKER STREET","Manhattan","1008199","10012","102","32","11","43","5","8.6"
"108 WEST HOUSTON STREET","Manhattan","1008252","10012","102","22","0","22","7","3.1"
"182 BLEECKER STREET","Manhattan","1008319","10012","102","13","1","14","4","3.5"
"43 WEST 8 STREET","Manhattan","1009446","10011","102","26","0","26","7","3.7"
"49 W 8TH ST","Manhattan","1009447","10011","102","34","0","34","6","5.7"
"54 WEST 10 STREET","Manhattan","1009461","10011","102","37","0","37","10","3.7"
"14 GAY STREET","Manhattan","1010282","10014","102","24","9","33","7","4.7"
"200 WEST 10 STREET","Manhattan","1011161","10014","102","15","2","17","4","4.3"
"69 HORATIO STREET","Manhattan","1012162","10014","102","17","0","17","4","4.3"
"406 WEST 25 STREET","Manhattan","1012805","10001","104","112","4","116","21","5.5"
"461 WEST   35 STREET","Manhattan","1012864","10001","104","54","2","56","14","4"
"454 WEST 36 STREET","Manhattan","1012879","10018","104","74","0","74","20","3.7"
"203 8 AVENUE","Manhattan","1013265","10011","104","6","31","37","12","3.1"
"352 WEST 39 STREET","Manhattan","1013653","10018","104","39","0","39","3","13"
"215 WEST   14 STREET","Manhattan","1013726","10011","104","59","3","62","18","3.4"
"152 7 AVENUE","Manhattan","1013980","10011","104","38","0","38","6","6.3"
"208 WEST 30 STREET","Manhattan","1014295","10001","105","183","38","221","6","36.8"
"404 8 AVENUE","Manhattan","1014333","10001","105","62","4","66","12","5.5"
"209 7 AVENUE","Manhattan","1014788","10011","104","18","0","18","5","3.6"
"763 6 AVENUE","Manhattan","1015015","10010","104","10","0","10","3","3.3"
"154 WEST 27 STREET","Manhattan","1015054","10001","105","73","4","77","12","6.4"
"136 WEST 28 STREET","Manhattan","1015092","10001","105","238","5","243","22","11"
"23 WEST 31 STREET","Manhattan","1015810","10001","105","19","1","20","4","5"
"45 EAST 28 STREET","Manhattan","1016906","10016","105","12","0","12","3","4"
"32 EAST 38 STREET","Manhattan","1017216","10016","106","25","2","27","6","4.5"
"110 EAST 20 STREET","Manhattan","1017942","10003","106","11","0","11","3","3.7"
"102 LEXINGTON AVENUE","Manhattan","1018168","10016","105","22","0","22","7","3.1"
"127 EAST 28 STREET","Manhattan","1018206","10016","105","20","1","21","7","3"
"145 EAST 35 STREET","Manhattan","1018905","10016","106","84","5","89","41","2.2"
"227 EAST 21 STREET","Manhattan","1019640","10010","106","72","8","80","6","13.3"
"627 2 AVENUE","Manhattan","1020155","10016","106","23","0","23","6","3.8"
"339 EAST 33 STREET","Manhattan","1021883","10016","106","25","0","25","7","3.6"
"325 WEST 42 STREET","Manhattan","1024941","10036","104","48","2","50","12","4.2"
"334 WEST 46 STREET","Manhattan","1025018","10036","104","31","0","31","3","10.3"
"330 WEST   47 STREET","Manhattan","1025065","10036","104","21","0","21","5","4.2"
"343 WEST 47 STREET","Manhattan","1025089","10036","104","0","40","40","4","10"
"318 WEST 49 STREET","Manhattan","1025149","10019","104","114","1","115","20","5.8"
"324 WEST 49 STREET","Manhattan","1025152","10019","104","45","10","55","17","3.2"
"328 WEST 49 STREET","Manhattan","1025154","10019","104","67","0","67","20","3.4"
"334 WEST 49 STREET","Manhattan","1025157","10019","104","64","5","69","20","3.5"
"338 WEST 49 STREET","Manhattan","1025159","10019","104","116","0","116","20","5.8"
"440 WEST 45 STREET","Manhattan","1026425","10036","104","79","5","84","17","4.9"
"410 WEST 46 STREET","Manhattan","1026461","10036","104","308","7","315","15","21"
"412 WEST 46 STREET","Manhattan","1026462","10036","104","13","34","47","15","3.1"
"460 WEST 46 STREET","Manhattan","1026472","10036","104","27","0","27","3","9"
"430 WEST 49 STREET","Manhattan","1026617","10019","104","48","1","49","10","4.9"
"432 WEST   49 STREET","Manhattan","1026618","10019","104","47","0","47","10","4.7"
"738 10 AVENUE","Manhattan","1026668","10019","104","32","11","43","6","7.2"
"853 9 AVENUE","Manhattan","1026854","10019","104","7","7","14","4","3.5"
"522 WEST 47 STREET","Manhattan","1026973","10036","104","65","0","65","10","6.5"
"114 WEST 71 STREET","Manhattan","1029766","10023","107","32","0","32","8","4"
"167 WEST 71 STREET","Manhattan","1029874","10023","107","93","0","93","21","4.4"
"260 COLUMBUS AVENUE","Manhattan","1029937","10023","107","49","8","57","9","6.3"
"169 WEST 76 STREET","Manhattan","1030171","10023","107","34","2","36","10","3.6"
"501 COLUMBUS AVENUE","Manhattan","1031291","10024","107","44","0","44","12","3.7"
"58 WEST 85 STREET","Manhattan","1031330","10024","107","13","0","13","4","3.3"
"68 WEST 85 STREET","Manhattan","1031334","10024","107","162","7","169","9","18.8"
"24 WEST 89 STREET","Manhattan","1031538","10024","107","7","64","71","8","8.9"
"44 WEST 89 STREET","Manhattan","1031540","10024","107","33","4","37","10","3.7"
"53 WEST 89 STREET","Manhattan","1031551","10024","107","33","10","43","10","4.3"
"33 WEST 89 STREET","Manhattan","1031558","10024","107","178","0","178","9","19.8"
"34 WEST 96 STREET","Manhattan","1031735","10025","107","27","0","27","9","3"
"460 COLUMBUS AVENUE","Manhattan","1032069","10024","107","29","0","29","3","9.7"
"137 WEST 83 STREET","Manhattan","1032117","10024","107","34","0","34","10","3.4"
"162 WEST 84 STREET","Manhattan","1032123","10024","107","28","0","28","5","5.6"
"142 WEST 87 STREET","Manhattan","1032214","10024","107","47","0","47","10","4.7"
"250 WEST 91 STREET","Manhattan","1033561","10024","107","122","2","124","14","8.9"
"698 AMSTERDAM AVENUE","Manhattan","1033649","10025","107","98","7","105","13","8.1"
"200 WEST 94 STREET","Manhattan","1033650","10025","107","126","12","138","13","10.6"
"317 WEST 88 STREET","Manhattan","1034063","10024","107","58","0","58","10","5.8"
"621 WEST END AVENUE","Manhattan","1034081","10024","107","27","0","27","8","3.4"
"58 EAST 56 STREET","Manhattan","1035774","10022","105","14","5","19","5","3.8"
"245 EAST 49 STREET","Manhattan","1038231","10017","106","0","13","13","3","4.3"
"981 2 AVENUE","Manhattan","1038476","10022","106","145","16","161","5","32.2"
"224 EAST 53 STREET","Manhattan","1038541","10022","106","11","0","11","3","3.7"
"840 2 AVENUE","Manhattan","1038763","10017","106","4","14","18","3","6"
"312 EAST 50 STREET","Manhattan","1039480","10022","106","39","0","39","4","9.8"
"312 EAST 51 STREET","Manhattan","1039640","10022","106","17","1","18","5","3.6"
"315 EAST 58 STREET","Manhattan","1040034","10022","106","33","4","37","10","3.7"
"43 EAST 63 STREET","Manhattan","1041034","10065","108","29","0","29","5","5.8"
"32 EAST 68 STREET","Manhattan","1041247","10065","108","31","0","31","10","3.1"
"164 EAST 61 STREET","Manhattan","1041933","10065","108","0","22","22","6","3.7"
"1433 2 AVENUE","Manhattan","1044030","10021","108","15","6","21","6","3.5"
"1496 2 AVENUE","Manhattan","1045225","10075","108","38","1","39","8","4.9"
"355 EAST   78 STREET","Manhattan","1045252","10075","108","25","3","28","8","3.5"
"1492 1 AVENUE","Manhattan","1046007","10075","108","22","0","22","7","3.1"
"1490 1 AVENUE","Manhattan","1046008","10075","108","18","0","18","6","3"
"23 EAST 81 STREET","Manhattan","1046666","10028","108","45","1","46","8","5.8"
"1566 3 AVENUE","Manhattan","1048057","10128","108","18","7","25","8","3.1"
"168 EAST   89 STREET","Manhattan","1048093","10128","108","21","0","21","4","5.3"
"1600 3 AVENUE","Manhattan","1048126","10128","108","107","3","110","34","3.2"
"203 EAST 82 STREET","Manhattan","1048684","10028","108","24","1","25","5","5"
"201 EAST 89 STREET","Manhattan","1048874","10128","108","47","23","70","14","5"
"1739 2 AVENUE","Manhattan","1048898","10128","108","93","1","94","8","11.8"
"325 EAST   92 STREET","Manhattan","1050251","10128","108","89","0","89","20","4.5"
"453 EAST 83 STREET","Manhattan","1050481","10028","108","82","1","83","8","10.4"
"400 EAST 88 STREET","Manhattan","1050606","10128","108","29","0","29","9","3.2"
"411 EAST 90 STREET","Manhattan","1050727","10128","108","39","0","39","11","3.5"
"500 EAST 84 STREET","Manhattan","1051207","10028","108","38","0","38","12","3.2"
"100 LENOX AVENUE","Manhattan","1051413","10026","110","48","17","65","20","3.3"
"10 EAST 116 STREET","Manhattan","1051659","10029","111","92","1","93","10","9.3"
"1411 5 AVENUE","Manhattan","1051662","10029","111","43","0","43","8","5.4"
"167 EAST 99 STREET","Manhattan","1051765","10029","111","62","0","62","19","3.3"
"111 EAST  100 STREET","Manhattan","1051786","10029","111","105","14","119","51","2.3"
"122 EAST 103 STREET","Manhattan","1051903","10029","111","76","0","76","24","3.2"
"118 EAST  103 STREET","Manhattan","1051904","10029","111","106","0","106","30","3.5"
"168 EAST 105 STREET","Manhattan","1051972","10029","111","27","0","27","4","6.8"
"1906 3 AVENUE","Manhattan","1051999","10029","111","25","0","25","8","3.1"
"1700 LEXINGTON AVENUE","Manhattan","1052063","10029","111","14","0","14","3","4.7"
"1781 LEXINGTON AVENUE","Manhattan","1052195","10029","111","19","0","19","6","3.2"
"160 EAST 111 STREET","Manhattan","1052200","10029","111","18","0","18","4","4.5"
"171 EAST 115 STREET","Manhattan","1052247","10029","111","57","0","57","8","7.1"
"112 EAST  116 STREET","Manhattan","1052270","10029","111","45","0","45","10","4.5"
"110 EAST  116 STREET","Manhattan","1052271","10029","111","62","0","62","11","5.6"
"108 EAST 116 STREET","Manhattan","1052272","10029","111","47","0","47","11","4.3"
"2001 3 AVENUE","Manhattan","1052445","10029","111","27","0","27","7","3.9"
"2145 2 AVENUE","Manhattan","1052467","10029","111","2","42","44","8","5.5"
"214 EAST 111 STREET","Manhattan","1052482","10029","111","60","3","63","7","9"
"253 EAST 110 STREET","Manhattan","1052486","10029","111","58","2","60","10","6"
"2263 2 AVENUE","Manhattan","1052583","10035","111","13","0","13","4","3.3"
"349 EAST 104 STREET","Manhattan","1052736","10029","111","24","0","24","8","3"
"324 EAST 109 STREET","Manhattan","1052815","10029","111","49","0","49","15","3.3"
"2121 1 AVENUE","Manhattan","1052837","10029","111","41","2","43","6","7.2"
"2127 1 AVENUE","Manhattan","1052840","10029","111","18","1","19","4","4.8"
"347 EAST 109 STREET","Manhattan","1052854","10029","111","48","1","49","14","3.5"
"2240 2 AVENUE","Manhattan","1052897","10029","111","32","1","33","5","6.6"
"313 EAST 115 STREET","Manhattan","1052902","10029","111","95","1","96","15","6.4"
"340 EAST 116 STREET","Manhattan","1052920","10029","111","9","1","10","3","3.3"
"322 EAST 116 STREET","Manhattan","1052924","10029","111","43","0","43","3","14.3"
"305 EAST 115 STREET","Manhattan","1052934","10029","111","38","0","38","6","6.3"
"411 EAST 114 STREET","Manhattan","1053007","10029","111","68","0","68","20","3.4"
"417 EAST 114 STREET","Manhattan","1053009","10029","111","35","0","35","8","4.4"
"419 EAST 114 STREET","Manhattan","1053010","10029","111","36","1","37","10","3.7"
"421 EAST 114 STREET","Manhattan","1053011","10029","111","65","0","65","8","8.1"
"273 PLEASANT AVENUE","Manhattan","1053037","10029","111","9","0","9","3","3"
"432 EAST 116 STREET","Manhattan","1053056","10029","111","94","1","95","11","8.6"
"413 EAST 117 STREET","Manhattan","1053109","10035","111","64","0","64","10","6.4"
"83 WEST 118 STREET","Manhattan","1053177","10026","110","11","2","13","4","3.3"
"73 WEST 118 STREET","Manhattan","1053181","10026","110","48","1","49","10","4.9"
"71 WEST  118 STREET","Manhattan","1053182","10026","110","36","3","39","10","3.9"
"69 WEST  118 STREET","Manhattan","1053183","10026","110","42","6","48","10","4.8"
"29 WEST 118 STREET","Manhattan","1053184","10026","110","95","0","95","20","4.8"
"81 WEST 119 STREET","Manhattan","1053292","10026","110","39","1","40","10","4"
"49 WEST 119 STREET","Manhattan","1053297","10026","110","37","3","40","11","3.6"
"14 MT MORRIS PARK WEST","Manhattan","1053367","10027","110","67","0","67","11","6.1"
"242 LENOX AVENUE","Manhattan","1053388","10027","110","39","8","47","15","3.1"
"22 MOUNT MORRIS PARK WEST","Manhattan","1053398","10027","110","76","2","78","22","3.5"
"23 WEST 123 STREET","Manhattan","1053420","10027","110","59","1","60","5","12"
"52 WEST  125 STREET","Manhattan","1053476","10027","110","13","0","13","4","3.3"
"2074 5 AVENUE","Manhattan","1053639","10035","110","29","0","29","4","7.3"
"38 WEST 128 STREET","Manhattan","1053651","10027","110","26","16","42","12","3.5"
"70 WEST 128 STREET","Manhattan","1053660","10027","110","45","1","46","9","5.1"
"33 WEST 128 STREET","Manhattan","1053715","10027","110","0","27","27","7","3.9"
"4 EAST  125 STREET","Manhattan","1054019","10035","111","17","1","18","3","6"
"77 EAST 125 STREET","Manhattan","1054042","10035","111","35","5","40","6","6.7"
"51 EAST 126 STREET","Manhattan","1054095","10035","111","59","14","73","7","10.4"
"14 EAST 127 STREET","Manhattan","1054125","10035","111","41","4","45","10","4.5"
"2049 5 AVENUE","Manhattan","1054129","10035","111","102","0","102","24","4.3"
"2024 MADISON AVENUE","Manhattan","1054178","10035","111","20","0","20","3","6.7"
"42 EAST 129 STREET","Manhattan","1054196","10035","111","72","0","72","10","7.2"
"2081 5 AVENUE","Manhattan","1054207","10035","111","51","4","55","5","11"
"2056 MADISON AVENUE","Manhattan","1054246","10035","111","36","0","36","3","12"
"2050 MADISON AVENUE","Manhattan","1054270","10035","111","45","0","45","3","15"
"66 EAST 131 STREET","Manhattan","1054288","10037","111","12","5","17","4","4.3"
"64 EAST 131 STREET","Manhattan","1054296","10037","111","11","1","12","4","3"
"27 EAST 131 STREET","Manhattan","1054307","10037","111","41","0","41","12","3.4"
"1948 PARK AVENUE","Manhattan","1054321","10037","111","34","0","34","10","3.4"
"2153 5 AVENUE","Manhattan","1054342","10037","111","76","0","76","10","7.6"
"157 EAST  118 STREET","Manhattan","1054350","10035","111","54","3","57","10","5.7"
"149 EAST  121 STREET","Manhattan","1054386","10035","111","17","0","17","5","3.4"
"182 EAST 122 STREET","Manhattan","1054395","10035","111","41","0","41","7","5.9"
"243 EAST 118 STREET","Manhattan","1054525","10035","111","15","2","17","4","4.3"
"2311 2 AVENUE","Manhattan","1054531","10035","111","136","0","136","8","17"
"2315 2 AVENUE","Manhattan","1054533","10035","111","31","2","33","9","3.7"
"2317 2 AVENUE","Manhattan","1054534","10035","111","48","1","49","9","5.4"
"240 EAST  119 STREET","Manhattan","1054535","10035","111","129","1","130","22","5.9"
"200 EAST 119 STREET","Manhattan","1054544","10035","111","25","0","25","8","3.1"
"246 EAST 119 STREET","Manhattan","1054553","10035","111","30","0","30","10","3"
"2411 2 AVENUE","Manhattan","1054648","10035","111","36","0","36","10","3.6"
"329 EAST 118 STREET","Manhattan","1054710","10035","111","61","1","62","4","15.5"
"348 EAST 119 STREET","Manhattan","1054723","10035","111","45","10","55","18","3.1"
"307 EAST 119 STREET","Manhattan","1054737","10035","111","61","10","71","12","5.9"
"347 EAST 119 STREET","Manhattan","1054750","10035","111","37","1","38","10","3.8"
"348 EAST 120 STREET","Manhattan","1054758","10035","111","48","0","48","10","4.8"
"302 EAST 126 STREET","Manhattan","1054801","10035","111","93","0","93","19","4.9"
"2310 1 AVENUE","Manhattan","1054846","10035","111","96","3","99","8","12.4"
"406 EAST  119 STREET","Manhattan","1054858","10035","111","158","0","158","10","15.8"
"130 WEST 111 STREET","Manhattan","1054942","10026","110","12","0","12","4","3"
"123 WEST 112 STREET","Manhattan","1054981","10026","110","77","0","77","12","6.4"
"100 WEST  113 STREET","Manhattan","1054986","10026","110","39","1","40","9","4.4"
"102 WEST 114 STREET","Manhattan","1055020","10026","110","24","0","24","5","4.8"
"1917 7 AVENUE","Manhattan","1055057","10026","110","127","4","131","31","4.2"
"2076 8 AVENUE","Manhattan","1055109","10026","110","62","0","62","13","4.8"
"10 MANHATTAN AVENUE","Manhattan","1055306","10025","107","119","5","124","42","3"
"7 WEST 108 STREET","Manhattan","1055722","10025","107","99","18","117","25","4.7"
"3 WEST 108 STREET","Manhattan","1055723","10025","107","80","4","84","25","3.4"
"344 MANHATTAN AVENUE","Manhattan","1055825","10026","110","37","0","37","10","3.7"
"315 WEST  114 STREET","Manhattan","1055826","10026","110","36","0","36","10","3.6"
"311 WEST 114 STREET","Manhattan","1055828","10026","110","65","0","65","15","4.3"
"2113 8 AVENUE","Manhattan","1055834","10026","110","97","0","97","9","10.8"
"2117 8 AVENUE","Manhattan","1055836","10026","110","54","0","54","12","4.5"
"2123 8 AVENUE","Manhattan","1055839","10026","110","65","0","65","9","7.2"
"346 MANHATTAN AVENUE","Manhattan","1055849","10026","110","99","5","104","49","2.1"
"101 WEST 106 STREET","Manhattan","1055966","10025","107","59","0","59","12","4.9"
"120 WEST  109 STREET","Manhattan","1056014","10025","107","108","0","108","15","7.2"
"2647 BROADWAY","Manhattan","1056486","10025","107","142","7","149","26","5.7"
"926 AMSTERDAM AVENUE","Manhattan","1056615","10025","107","162","0","162","10","16.2"
"205 WEST  107 STREET","Manhattan","1056655","10025","107","42","1","43","14","3.1"
"964 AMSTERDAM AVENUE","Manhattan","1056658","10025","107","73","0","73","23","3.2"
"212 WEST 109 STREET","Manhattan","1056686","10025","107","76","0","76","20","3.8"
"249 WEST 109 STREET","Manhattan","1056696","10025","107","62","0","62","16","3.9"
"209 WEST 109 STREET","Manhattan","1056708","10025","107","97","0","97","15","6.5"
"315 WEST 102 STREET","Manhattan","1057176","10025","107","141","5","146","36","4.1"
"301 WEST  106 STREET","Manhattan","1057263","10025","107","110","9","119","46","2.6"
"133 WEST  116 STREET","Manhattan","1057399","10026","110","33","0","33","11","3"
"129 WEST  116 STREET","Manhattan","1057401","10026","110","27","0","27","9","3"
"125 WEST 116 STREET","Manhattan","1057402","10026","110","72","0","72","16","4.5"
"117 WEST 116 STREET","Manhattan","1057404","10026","110","77","0","77","16","4.8"
"131 WEST 118 STREET","Manhattan","1057480","10026","110","72","0","72","11","6.5"
"1987 7 AVENUE","Manhattan","1057532","10026","110","47","0","47","10","4.7"
"197 LENOX AVENUE","Manhattan","1057560","10026","110","182","1","183","10","18.3"
"185 LENOX AVENUE","Manhattan","1057592","10026","110","17","0","17","5","3.4"
"142 WEST 120 STREET","Manhattan","1057598","10027","110","14","0","14","4","3.5"
"2021 7 AVENUE","Manhattan","1057675","10027","110","27","0","27","9","3"
"231 LENOX AVENUE","Manhattan","1057688","10027","110","0","18","18","3","6"
"2035 7 AVENUE","Manhattan","1057699","10027","110","98","1","99","16","6.2"
"126 WEST 124 STREET","Manhattan","1057798","10027","110","80","3","83","9","9.2"
"128 WEST 124 STREET","Manhattan","1057799","10027","110","41","1","42","4","10.5"
"144 WEST  124 STREET","Manhattan","1057803","10027","110","92","0","92","9","10.2"
"146 WEST  124 STREET","Manhattan","1057804","10027","110","146","4","150","11","13.6"
"136 WEST 129 STREET","Manhattan","1057959","10027","110","31","0","31","4","7.8"
"158 WEST 132 STREET","Manhattan","1058117","10027","110","93","3","96","8","12"
"162 WEST 132 STREET","Manhattan","1058118","10027","110","188","17","205","12","17.1"
"2247 7 AVENUE","Manhattan","1058139","10027","110","55","0","55","16","3.4"
"124 WEST 134 STREET","Manhattan","1058234","10030","110","38","0","38","10","3.8"
"185 WEST 135 STREET","Manhattan","1058263","10030","110","21","0","21","5","4.2"
"179 WEST 135 STREET","Manhattan","1058264","10030","110","103","7","110","24","4.6"
"163 WEST  136 STREET","Manhattan","1058312","10030","110","110","0","110","16","6.9"
"531 LENOX AVENUE","Manhattan","1058335","10037","110","93","0","93","10","9.3"
"102 WEST  137 STREET","Manhattan","1058338","10030","110","34","1","35","6","5.8"
"106 WEST  137 STREET","Manhattan","1058339","10030","110","63","0","63","20","3.1"
"110 WEST 137 STREET","Manhattan","1058341","10030","110","60","0","60","10","6"
"124 WEST  137 STREET","Manhattan","1058345","10030","110","131","0","131","20","6.5"
"174 WEST 137 STREET","Manhattan","1058351","10030","110","90","0","90","21","4.3"
"176 WEST  137 STREET","Manhattan","1058352","10030","110","79","0","79","15","5.3"
"278 WEST 118 STREET","Manhattan","1058402","10026","110","34","0","34","10","3.4"
"2190 8 AVENUE","Manhattan","1058408","10026","110","49","1","50","8","6.3"
"279 WEST 118 STREET","Manhattan","1058412","10026","110","46","0","46","10","4.6"
"277 WEST 118 STREET","Manhattan","1058413","10026","110","29","3","32","10","3.2"
"275 WEST 118 STREET","Manhattan","1058414","10026","110","80","0","80","10","8"
"273 WEST 118 STREET","Manhattan","1058415","10026","110","108","0","108","10","10.8"
"2198 8 AVENUE","Manhattan","1058437","10026","110","35","0","35","8","4.4"
"271 WEST 119 STREET","Manhattan","1058443","10026","110","48","2","50","13","3.8"
"202 ST NICHOLAS AVENUE","Manhattan","1058463","10027","110","56","1","57","10","5.7"
"222 ST NICHOLAS AVENUE","Manhattan","1058491","10027","110","30","10","40","9","4.4"
"259 WEST 121 STREET","Manhattan","1058496","10027","110","26","1","27","8","3.4"
"2034 7 AVENUE","Manhattan","1058515","10027","110","396","20","416","57","7.3"
"234 WEST 122 STREET","Manhattan","1058527","10027","110","81","0","81","14","5.8"
"259 WEST  122 STREET","Manhattan","1058550","10027","110","91","0","91","10","9.1"
"257 WEST 122 STREET","Manhattan","1058551","10027","110","64","0","64","10","6.4"
"2058 7 AVENUE","Manhattan","1058567","10027","110","27","0","27","9","3"
"268 WEST 132 STREET","Manhattan","1058759","10027","110","30","1","31","7","4.4"
"200 WEST  133 STREET","Manhattan","1058785","10030","110","39","0","39","9","4.3"
"2490 8 AVENUE","Manhattan","1058804","10030","110","56","13","69","12","5.8"
"2494 8 AVENUE","Manhattan","1058806","10030","110","26","2","28","9","3.1"
"234 WEST 135 STREET","Manhattan","1058850","10030","110","107","0","107","29","3.7"
"235 WEST 135 STREET","Manhattan","1058877","10030","110","25","0","25","8","3.1"
"213 WEST  135 STREET","Manhattan","1058886","10030","110","46","2","48","11","4.4"
"209 WEST 135 STREET","Manhattan","1058888","10030","110","21","4","25","5","5"
"2302 7 AVENUE","Manhattan","1058893","10030","110","25","0","25","8","3.1"
"2304 7 AVENUE","Manhattan","1058894","10030","110","47","0","47","10","4.7"
"2308 7 AVENUE","Manhattan","1058896","10030","110","60","2","62","17","3.6"
"2310 7 AVENUE","Manhattan","1058897","10030","110","67","2","69","10","6.9"
"200 WEST  136 STREET","Manhattan","1058898","10030","110","62","0","62","8","7.8"
"251 WEST 136 STREET","Manhattan","1058939","10030","110","17","0","17","5","3.4"
"361 WEST 116 STREET","Manhattan","1059005","10026","110","30","1","31","10","3.1"
"385 MANHATTAN AVENUE","Manhattan","1059007","10026","110","49","0","49","3","16.3"
"411 MANHATTAN AVENUE","Manhattan","1059059","10026","110","39","0","39","10","3.9"
"437 MANHATTAN AVENUE","Manhattan","1059094","10026","110","133","11","144","53","2.7"
"63 MORNINGSIDE AVENUE","Manhattan","1059163","10027","110","225","34","259","10","25.9"
"344 WEST 121 STREET","Manhattan","1059170","10027","110","45","0","45","10","4.5"
"315 WEST 121 STREET","Manhattan","1059193","10027","110","56","0","56","16","3.5"
"520 MANHATTAN AVENUE","Manhattan","1059203","10027","110","79","1","80","23","3.5"
"109 MORNINGSIDE AVENUE","Manhattan","1059284","10027","109","45","1","46","10","4.6"
"351 WEST  125 STREET","Manhattan","1059309","10027","109","172","6","178","38","4.7"
"377 WEST 125 STREET","Manhattan","1059320","10027","109","10","2","12","3","4"
"363 WEST 126 STREET","Manhattan","1059329","10027","109","76","0","76","20","3.8"
"361 WEST 126 STREET","Manhattan","1059330","10027","109","65","0","65","20","3.3"
"2359 8 AVENUE","Manhattan","1059343","10027","110","32","2","34","10","3.4"
"366 WEST 127 STREET","Manhattan","1059358","10027","109","58","1","59","8","7.4"
"372 WEST 127 STREET","Manhattan","1059361","10027","109","34","0","34","10","3.4"
"376 WEST 127 STREET","Manhattan","1059363","10027","109","34","1","35","10","3.5"
"301 WEST 128 STREET","Manhattan","1059398","10027","110","18","0","18","4","4.5"
"2445 8 AVENUE","Manhattan","1059412","10027","110","62","0","62","13","4.8"
"452 ST NICHOLAS AVENUE","Manhattan","1059432","10027","110","35","1","36","10","3.6"
"488 ST NICHOLAS AVENUE","Manhattan","1059459","10030","110","94","0","94","30","3.1"
"464 WEST 126 STREET","Manhattan","1059558","10027","109","76","0","76","19","4"
"35 ST NICHOLAS TERRACE","Manhattan","1059597","10027","109","122","2","124","55","2.3"
"1473 AMSTERDAM AVENUE","Manhattan","1059634","10027","109","22","0","22","4","5.5"
"1465 AMSTERDAM AVENUE","Manhattan","1059637","10027","109","43","2","45","14","3.2"
"496 WEST  133 STREET","Manhattan","1059644","10027","109","77","0","77","16","4.8"
"505 WEST 122 STREET","Manhattan","1059673","10027","109","60","1","61","18","3.4"
"503 WEST 122 STREET","Manhattan","1059674","10027","109","92","2","94","18","5.2"
"522 WEST 123 STREET","Manhattan","1059683","10027","109","38","0","38","10","3.8"
"528 WEST 123 STREET","Manhattan","1059686","10027","109","120","1","121","48","2.5"
"1350 AMSTERDAM AVENUE","Manhattan","1059701","10027","109","159","0","159","16","9.9"
"504 WEST 126 STREET","Manhattan","1059703","10027","109","68","1","69","18","3.8"
"545 WEST  133 STREET","Manhattan","1059731","10027","109","66","0","66","15","4.4"
"1488 AMSTERDAM AVENUE","Manhattan","1059740","10031","109","56","0","56","18","3.1"
"516 WEST 134 STREET","Manhattan","1059746","10031","109","128","0","128","21","6.1"
"3340 BROADWAY","Manhattan","1059780","10031","109","82","4","86","37","2.3"
"528 WEST 136 STREET","Manhattan","1059808","10031","109","83","7","90","37","2.4"
"192 CLAREMONT AVENUE","Manhattan","1059860","10027","109","82","3","85","20","4.3"
"601 WEST 135 STREET","Manhattan","1059958","10031","109","159","26","185","45","4.1"
"620 WEST 137 STREET","Manhattan","1059968","10031","109","76","1","77","25","3.1"
"618 WEST 136 STREET","Manhattan","1059976","10031","109","119","9","128","29","4.4"
"622 WEST  136 STREET","Manhattan","1059977","10031","109","81","1","82","16","5.1"
"105 WEST  137 STREET","Manhattan","1060000","10030","110","62","1","63","17","3.7"
"111 WEST  138 STREET","Manhattan","1060027","10030","110","38","11","49","10","4.9"
"151 WEST 140 STREET","Manhattan","1060063","10030","110","163","12","175","55","3.2"
"160 WEST 141 STREET","Manhattan","1060076","10030","110","58","2","60","14","4.3"
"137 WEST 141 STREET","Manhattan","1060085","10030","110","159","2","161","49","3.3"
"117 WEST 141 STREET","Manhattan","1060087","10030","110","175","2","177","49","3.6"
"133 WEST 145 STREET","Manhattan","1060186","10039","110","77","23","100","29","3.4"
"2621 7 AVENUE","Manhattan","1060197","10039","110","43","0","43","8","5.4"
"2394 7 AVENUE","Manhattan","1060372","10030","110","165","5","170","51","3.3"
"215 WEST  140 STREET","Manhattan","1060408","10030","110","58","0","58","15","3.9"
"215 WEST 144 STREET","Manhattan","1060452","10030","110","186","0","186","41","4.5"
"2484 7 AVENUE","Manhattan","1060457","10030","110","69","1","70","23","3"
"271 WEST  146 STREET","Manhattan","1060497","10039","110","208","0","208","20","10.4"
"269 WEST 146 STREET","Manhattan","1060498","10039","110","115","0","115","20","5.8"
"267 WEST 146 STREET","Manhattan","1060499","10039","110","86","2","88","20","4.4"
"201 WEST  146 STREET","Manhattan","1060506","10039","110","95","0","95","12","7.9"
"292 WEST 147 STREET","Manhattan","1060515","10039","110","76","3","79","15","5.3"
"204 WEST 149 STREET","Manhattan","1060570","10039","110","43","0","43","10","4.3"
"216 WEST 149 STREET","Manhattan","1060573","10039","110","68","0","68","18","3.8"
"263 WEST  152 STREET","Manhattan","1060608","10039","110","156","1","157","25","6.3"
"270 WEST 153 STREET","Manhattan","1060614","10039","110","120","2","122","25","4.9"
"254 WEST 154 STREET","Manhattan","1060623","10039","110","102","8","110","28","3.9"
"2591 8 AVENUE","Manhattan","1060668","10030","110","154","0","154","8","19.3"
"306 WEST 139 STREET","Manhattan","1060674","10030","110","14","0","14","3","4.7"
"54 EDGECOMBE AVENUE","Manhattan","1060684","10030","110","133","0","133","12","11.1"
"305 WEST 139 STREET","Manhattan","1060731","10030","110","49","1","50","13","3.8"
"300 WEST 142 STREET","Manhattan","1060752","10030","110","56","1","57","13","4.4"
"304 WEST 147 STREET","Manhattan","1060814","10039","110","135","0","135","33","4.1"
"310 WEST 153 STREET","Manhattan","1060873","10039","110","103","12","115","19","6.1"
"2919 8 AVENUE","Manhattan","1060899","10039","110","34","0","34","9","3.8"
"45 HAMILTON TERRACE","Manhattan","1060996","10031","109","176","0","176","9","19.6"
"141 EDGECOMBE AVENUE","Manhattan","1061046","10030","109","103","0","103","18","5.7"
"656 ST NICHOLAS AVENUE","Manhattan","1061049","10030","109","282","3","285","31","9.2"
"367 EDGECOMBE AVENUE","Manhattan","1061166","10031","109","83","0","83","23","3.6"
"76 ST NICHOLAS PLACE","Manhattan","1061188","10032","109","226","25","251","31","8.1"
"470 WEST 141 STREET","Manhattan","1061211","10031","109","29","0","29","8","3.6"
"1661 AMSTERDAM AVENUE","Manhattan","1061246","10031","109","27","112","139","8","17.4"
"332 CONVENT AVENUE","Manhattan","1061284","10031","109","27","0","27","8","3.4"
"468 WEST 144 STREET","Manhattan","1061295","10031","109","142","15","157","11","14.3"
"474 WEST 144 STREET","Manhattan","1061298","10031","109","97","1","98","10","9.8"
"475 WEST 145 STREET","Manhattan","1061341","10031","109","170","2","172","20","8.6"
"404 WEST 146 STREET","Manhattan","1061354","10031","109","75","9","84","11","7.6"
"454 WEST 146 STREET","Manhattan","1061364","10031","109","32","0","32","10","3.2"
"415 WEST 145 STREET","Manhattan","1061371","10031","109","37","0","37","8","4.6"
"1739 AMSTERDAM AVENUE","Manhattan","1061376","10031","109","89","2","91","13","7"
"729 ST NICHOLAS AVENUE","Manhattan","1061396","10031","109","63","1","64","14","4.6"
"453 WEST 148 STREET","Manhattan","1061492","10031","109","15","0","15","4","3.8"
"761 ST NICHOLAS AVENUE","Manhattan","1061511","10031","109","35","0","35","8","4.4"
"401 WEST 149 STREET","Manhattan","1061543","10031","109","27","1","28","6","4.7"
"460 CONVENT AVENUE","Manhattan","1061575","10031","109","45","0","45","15","3"
"400 WEST 151 STREET","Manhattan","1061584","10031","109","48","1","49","10","4.9"
"471 CONVENT AVENUE","Manhattan","1061586","10031","109","16","5","21","3","7"
"465 WEST 152 STREET","Manhattan","1061612","10031","109","82","0","82","36","2.3"
"47 ST NICHOLAS PLACE","Manhattan","1061620","10031","109","32","0","32","8","4"
"55 ST NICHOLAS PLACE","Manhattan","1061623","10031","109","19","0","19","4","4.8"
"61 HAMILTON PLACE","Manhattan","1061743","10031","109","87","3","90","25","3.6"
"509 WEST 140 STREET","Manhattan","1061764","10031","109","46","0","46","15","3.1"
"552 WEST 141 STREET","Manhattan","1061773","10031","109","121","2","123","25","4.9"
"572 WEST 141 STREET","Manhattan","1061775","10031","109","230","10","240","24","10"
"93 HAMILTON PLACE","Manhattan","1061793","10031","109","90","2","92","23","4"
"542 WEST 142 STREET","Manhattan","1061820","10031","109","25","1","26","8","3.3"
"505 WEST 142 STREET","Manhattan","1061858","10031","109","70","10","80","18","4.4"
"115 HAMILTON PLACE","Manhattan","1061859","10031","109","163","22","185","26","7.1"
"1670 AMSTERDAM AVENUE","Manhattan","1061861","10031","109","68","13","81","35","2.3"
"561 WEST  144 STREET","Manhattan","1061897","10031","109","76","1","77","21","3.7"
"533 WEST 144 STREET","Manhattan","1061905","10031","109","38","2","40","5","8"
"535 WEST 144 STREET","Manhattan","1061923","10031","109","22","2","24","5","4.8"
"533 WEST 145 STREET","Manhattan","1061930","10031","109","103","0","103","15","6.9"
"531 WEST 145 STREET","Manhattan","1061931","10031","109","101","0","101","13","7.8"
"1732 AMSTERDAM AVENUE","Manhattan","1061945","10031","109","50","0","50","8","6.3"
"506 WEST 146 STREET","Manhattan","1061947","10031","109","44","18","62","18","3.4"
"515 WEST 147 STREET","Manhattan","1061978","10031","109","63","2","65","21","3.1"
"3600 BROADWAY","Manhattan","1062014","10031","109","58","3","61","19","3.2"
"3604 BROADWAY","Manhattan","1062015","10031","109","30","0","30","10","3"
"556 WEST 150 STREET","Manhattan","1062119","10031","109","43","0","43","8","5.4"
"561 WEST 150 STREET","Manhattan","1062138","10031","109","183","1","184","31","5.9"
"557 WEST 150 STREET","Manhattan","1062139","10031","109","104","1","105","31","3.4"
"525 WEST 150 STREET","Manhattan","1062146","10031","109","29","0","29","8","3.6"
"513 WEST 150 STREET","Manhattan","1062150","10031","109","45","2","47","12","3.9"
"510 WEST 151 STREET","Manhattan","1062159","10031","109","85","0","85","14","6.1"
"521 WEST 150 STREET","Manhattan","1062172","10031","109","81","4","85","10","8.5"
"515 WEST 150 STREET","Manhattan","1062173","10031","109","38","4","42","8","5.3"
"586 WEST 152 STREET","Manhattan","1062204","10031","109","76","0","76","21","3.6"
"3694 BROADWAY","Manhattan","1062252","10031","109","76","1","77","25","3.1"
"636 WEST  138 STREET","Manhattan","1062281","10031","109","68","0","68","21","3.2"
"613 WEST 140 STREET","Manhattan","1062318","10031","109","465","22","487","47","10.4"
"635 RIVERSIDE DRIVE","Manhattan","1062325","10031","109","144","13","157","68","2.3"
"3507 BROADWAY","Manhattan","1062361","10031","109","107","7","114","45","2.5"
"706 RIVERSIDE DRIVE","Manhattan","1062427","10031","109","218","6","224","51","4.4"
"601 WEST 149 STREET","Manhattan","1062443","10031","109","121","3","124","48","2.6"
"2013 AMSTERDAM AVENUE","Manhattan","1062533","10032","112","103","4","107","23","4.7"
"974 ST NICHOLAS AVENUE","Manhattan","1062536","10032","112","117","0","117","44","2.7"
"425 WEST 162 STREET","Manhattan","1062599","10032","112","126","1","127","10","12.7"
"452 WEST 164 STREET","Manhattan","1062622","10032","112","72","0","72","20","3.6"
"438 WEST 164 STREET","Manhattan","1062626","10032","112","204","0","204","22","9.3"
"470 WEST 166 STREET","Manhattan","1062647","10032","112","65","13","78","21","3.7"
"554 WEST 156 STREET","Manhattan","1062681","10032","112","28","0","28","4","7"
"550 WEST 156 STREET","Manhattan","1062682","10032","112","28","0","28","4","7"
"575 WEST 155 STREET","Manhattan","1062697","10032","112","104","6","110","29","3.8"
"504 WEST 157 STREET","Manhattan","1062711","10032","112","38","1","39","9","4.3"
"512 WEST 158 STREET","Manhattan","1062736","10032","112","62","2","64","16","4"
"525 WEST 157 STREET","Manhattan","1062743","10032","112","77","0","77","35","2.2"
"538 WEST 159 STREET","Manhattan","1062752","10032","112","258","4","262","10","26.2"
"536 WEST 159 STREET","Manhattan","1062753","10032","112","54","0","54","10","5.4"
"534 WEST 159 STREET","Manhattan","1062754","10032","112","92","0","92","20","4.6"
"532 WEST 159 STREET","Manhattan","1062755","10032","112","85","0","85","20","4.3"
"530 WEST 159 STREET","Manhattan","1062756","10032","112","81","0","81","10","8.1"
"528 WEST  159 STREET","Manhattan","1062757","10032","112","42","0","42","11","3.8"
"522 WEST 159 STREET","Manhattan","1062759","10032","112","49","0","49","16","3.1"
"507 WEST 158 STREET","Manhattan","1062772","10032","112","169","2","171","16","10.7"
"564 WEST 160 STREET","Manhattan","1062784","10032","112","104","0","104","38","2.7"
"513 WEST 159 STREET","Manhattan","1062801","10032","112","39","0","39","10","3.9"
"515 WEST 160 STREET","Manhattan","1062839","10032","112","131","0","131","20","6.5"
"1090 ST NICHOLAS AVENUE","Manhattan","1062893","10032","112","87","0","87","41","2.1"
"2108 AMSTERDAM AVENUE","Manhattan","1062897","10032","112","50","0","50","13","3.8"
"527 WEST  162 STREET","Manhattan","1062915","10032","112","36","0","36","10","3.6"
"531 WEST 162 STREET","Manhattan","1062917","10032","112","109","1","110","11","10"
"3924 BROADWAY","Manhattan","1062927","10032","112","20","4","24","7","3.4"
"546 WEST 165 STREET","Manhattan","1062932","10032","112","70","0","70","6","11.7"
"61 AUDUBON AVENUE","Manhattan","1062997","10032","112","64","0","64","10","6.4"
"559 WEST 169 STREET","Manhattan","1063018","10032","112","98","4","102","20","5.1"
"500 WEST 170 STREET","Manhattan","1063029","10032","112","62","0","62","20","3.1"
"1228 ST NICHOLAS AVENUE","Manhattan","1063063","10032","112","122","0","122","45","2.7"
"1238 ST NICHOLAS AVENUE","Manhattan","1063086","10032","112","290","0","290","40","7.3"
"155 AUDUBON AVENUE","Manhattan","1063100","10032","112","108","0","108","49","2.2"
"527 WEST  173 STREET","Manhattan","1063147","10032","112","10","0","10","3","3.3"
"189 AUDUBON AVENUE","Manhattan","1063161","10033","112","46","0","46","15","3.1"
"191 AUDUBON AVENUE","Manhattan","1063162","10033","112","22","1","23","6","3.8"
"580 WEST 176 STREET","Manhattan","1063218","10033","112","108","7","115","31","3.7"
"574 WEST 176 STREET","Manhattan","1063219","10033","112","271","0","271","30","9"
"1356 ST NICHOLAS AVENUE","Manhattan","1063235","10033","112","88","0","88","13","6.8"
"3765 BROADWAY","Manhattan","1063255","10032","112","95","5","100","41","2.4"
"846 RIVERSIDE DRIVE","Manhattan","1063309","10032","112","153","0","153","62","2.5"
"674 WEST 161 STREET","Manhattan","1063328","10032","112","195","0","195","43","4.5"
"75 FT WASHINGTON AVENUE","Manhattan","1063331","10032","112","125","0","125","56","2.2"
"65 FT WASHINGTON AVENUE","Manhattan","1063332","10032","112","193","7","200","42","4.8"
"657 WEST 161 STREET","Manhattan","1063333","10032","112","163","1","164","49","3.3"
"671 WEST 162 STREET","Manhattan","1063342","10032","112","100","0","100","49","2"
"238 FT WASHINGTON AVENUE","Manhattan","1063386","10032","112","87","0","87","42","2.1"
"705 WEST 170 STREET","Manhattan","1063416","10032","112","257","8","265","21","12.6"
"709 WEST  170 STREET","Manhattan","1063417","10032","112","257","9","266","21","12.7"
"362 FT WASHINGTON AVENUE","Manhattan","1063507","10033","112","163","0","163","75","2.2"
"608 WEST 177 STREET","Manhattan","1063543","10033","112","290","2","292","52","5.6"
"608 WEST 178 STREET","Manhattan","1063548","10033","112","100","0","100","22","4.5"
"2541 AMSTERDAM AVENUE","Manhattan","1063584","10033","112","144","12","156","60","2.6"
"568 WEST 182 STREET","Manhattan","1063643","10033","112","78","3","81","26","3.1"
"1464 ST NICHOLAS AVENUE","Manhattan","1063672","10033","112","26","1","27","8","3.4"
"555 WEST 183 STREET","Manhattan","1063683","10033","112","41","4","45","4","11.3"
"564 WEST 183 STREET","Manhattan","1063692","10033","112","30","1","31","10","3.1"
"2498 AMSTERDAM AVENUE","Manhattan","1063712","10033","112","13","0","13","3","4.3"
"509 WEST  183 STREET","Manhattan","1063717","10033","112","130","0","130","31","4.2"
"1520 ST NICHOLAS AVENUE","Manhattan","1063788","10033","112","99","0","99","23","4.3"
"546 WEST 188 STREET","Manhattan","1063812","10040","112","14","0","14","4","3.5"
"510 WEST 190 STREET","Manhattan","1063856","10040","112","167","0","167","44","3.8"
"607 WEST 180 STREET","Manhattan","1063913","10033","112","103","0","103","21","4.9"
"620 WEST  182 STREET","Manhattan","1063940","10033","112","93","0","93","16","5.8"
"605 WEST  182 STREET","Manhattan","1063951","10033","112","141","1","142","22","6.5"
"371 WADSWORTH AVENUE","Manhattan","1064025","10040","112","122","3","125","41","3"
"606 WEST 191 STREET","Manhattan","1064032","10040","112","89","0","89","21","4.2"
"25 NAGLE AVENUE","Manhattan","1064122","10040","112","93","3","96","48","2"
"4646 BROADWAY","Manhattan","1064139","10040","112","98","0","98","43","2.3"
"146 NAGLE AVENUE","Manhattan","1064178","10040","112","132","0","132","47","2.8"
"105 ELLWOOD STREET","Manhattan","1064190","10040","112","111","0","111","49","2.3"
"78 THAYER STREET","Manhattan","1064249","10040","112","126","3","129","63","2"
"407 WEST 205 STREET","Manhattan","1064506","10034","112","126","0","126","29","4.3"
"3853 10 AVENUE","Manhattan","1064508","10034","112","93","0","93","23","4"
"99 MARBLE HILL AVENUE","Bronx","1064584","10463","208","132","19","151","56","2.7"
"109 WEST 225 STREET","Bronx","1064669","10463","208","39","6","45","9","5"
"17 POST AVENUE","Manhattan","1064709","10034","112","144","9","153","49","3.1"
"121 POST AVENUE","Manhattan","1064736","10034","112","34","0","34","11","3.1"
"123 POST AVENUE","Manhattan","1064737","10034","112","61","0","61","11","5.5"
"165 SHERMAN AVENUE","Manhattan","1064768","10034","112","249","6","255","100","2.5"
"53 VERMILYEA AVENUE","Manhattan","1064819","10034","112","83","1","84","25","3.4"
"152 SHERMAN AVENUE","Manhattan","1064832","10034","112","104","0","104","41","2.5"
"611 ACADEMY STREET","Manhattan","1064834","10034","112","100","0","100","48","2.1"
"64 VERMILYEA AVENUE","Manhattan","1064909","10034","112","62","2","64","21","3"
"98 VERMILYEA AVENUE","Manhattan","1064921","10034","112","192","2","194","57","3.4"
"15 COOPER STREET","Manhattan","1064952","10034","112","115","1","116","21","5.5"
"677 WEST 204 STREET","Manhattan","1064986","10034","112","100","4","104","31","3.4"
"639 WEST 207 STREET","Manhattan","1064990","10034","112","140","0","140","56","2.5"
"34 SEAMAN AVENUE","Manhattan","1065059","10034","112","131","0","131","60","2.2"
"447 WEST   45 STREET","Manhattan","1070034","10036","104","124","0","124","34","3.6"
"514 HUDSON STREET","Manhattan","1075681","10014","102","29","1","30","7","4.3"
"2809 8 AVENUE","Manhattan","1076723","10039","110","176","0","176","22","8"
"280 WADSWORTH AVENUE","Manhattan","1076753","10040","112","20","0","20","3","6.7"
"84 NAGLE AVENUE","Manhattan","1076759","10040","112","33","5","38","5","7.6"
"16 CHRISTOPHER STREET","Manhattan","1076824","10014","102","4","18","22","6","3.7"
"18 GAY STREET","Manhattan","1076825","10014","102","37","8","45","7","6.4"
"205 AVENUE B","Manhattan","1076876","10009","103","27","1","28","6","4.7"
"207 AVENUE B","Manhattan","1076878","10009","103","67","14","81","6","13.5"
"219 EAST    5 STREET","Manhattan","1076946","10003","103","33","2","35","10","3.5"
"514 EAST   13 STREET","Manhattan","1077004","10009","103","29","0","29","8","3.6"
"221 EAST   35 STREET","Manhattan","1077033","10016","106","73","7","80","16","5"
"20 MULBERRY STREET","Manhattan","1077118","10013","103","19","0","19","6","3.2"
"59 BAYARD STREET","Manhattan","1077443","10013","103","33","0","33","8","4.1"
"435 EAST    9 STREET","Manhattan","1077648","10009","103","41","0","41","8","5.1"
"191 AVENUE A","Manhattan","1077670","10009","103","15","1","16","3","5.3"
"446 EAST   13 STREET","Manhattan","1077675","10009","103","15","0","15","3","5"
"83 1 AVENUE","Manhattan","1077683","10003","103","30","4","34","10","3.4"
"509 EAST   81 STREET","Manhattan","1078714","10028","108","231","3","234","20","11.7"
"533 EAST   81 STREET","Manhattan","1078722","10028","108","32","0","32","10","3.2"
"159 EAST 33 STREET","Manhattan","1078758","10016","106","6","13","19","6","3.2"
"60 MULBERRY STREET","Manhattan","1079236","10013","103","74","1","75","10","7.5"
"530 WEST 50 STREET","Manhattan","1079257","10019","104","73","0","73","8","9.1"
"1969 MADISON AVENUE","Manhattan","1079422","10035","111","15","0","15","4","3.8"
"414 EAST 119 STREET","Manhattan","1079441","10035","111","63","0","63","20","3.1"
"640 WEST  139 STREET","Manhattan","1079500","10031","109","136","12","148","62","2.4"
"1809 AMSTERDAM AVENUE","Manhattan","1079830","10031","109","62","0","62","16","3.9"
"1466 ST NICHOLAS AVENUE","Manhattan","1079907","10033","112","71","0","71","8","8.9"
"128 SEAMAN AVENUE","Manhattan","1080545","10034","112","189","0","189","24","7.9"
"132 SEAMAN AVENUE","Manhattan","1080546","10034","112","87","0","87","24","3.6"
"136 SEAMAN AVENUE","Manhattan","1080547","10034","112","114","0","114","24","4.8"
"140 SEAMAN AVENUE","Manhattan","1080548","10034","112","90","0","90","21","4.3"
"144 SEAMAN AVENUE","Manhattan","1080549","10034","112","77","0","77","20","3.9"
"191 7 AVENUE","Manhattan","1080586","10011","104","20","1","21","6","3.5"
"2016 3 AVENUE","Manhattan","1080662","10029","111","38","1","39","3","13"
"2259 2 AVENUE","Manhattan","1080716","10029","111","38","0","38","3","12.7"
"242 WEST  116 STREET","Manhattan","1081572","10026","110","51","4","55","8","6.9"
"240 WEST  116 STREET","Manhattan","1081574","10026","110","57","3","60","4","15"
"2236 7 AVENUE","Manhattan","1081610","10027","110","13","0","13","4","3.3"
"2240 7 AVENUE","Manhattan","1081612","10027","110","39","0","39","8","4.9"
"2232 7 AVENUE","Manhattan","1081613","10027","110","24","0","24","4","6"
"22REAR MULBERRY STREET","Manhattan","1081975","10013","103","20","0","20","4","5"
"739 9 AVENUE","Manhattan","1082400","10019","104","61","0","61","15","4.1"
"400 WEST   50 STREET","Manhattan","1082401","10019","104","61","0","61","15","4.1"
"455 WEST   56 STREET","Manhattan","1082420","10019","104","30","0","30","3","10"
"50 DELANCEY STREET","Manhattan","1082505","10002","103","18","10","28","5","5.6"
"19 COOPER STREET","Manhattan","1083055","10034","112","113","0","113","21","5.4"
"302 WEST   40 STREET","Manhattan","1083619","10018","104","31","0","31","10","3.1"
"24 MULBERRY STREET","Manhattan","1083714","10013","103","37","0","37","7","5.3"
"198 LENOX AVENUE","Manhattan","1083964","10026","110","37","0","37","8","4.6"
"2178 LEXINGTON AVENUE","Manhattan","1084001","10037","111","88","0","88","42","2.1"
"2518 FREDERICK DOUGLASS BLVD","Manhattan","1084051","10030","110","167","4","171","22","7.8"
"2580 7 AVENUE","Manhattan","1084144","10039","110","211","0","211","91","2.3"
"508 E 11 ST","Manhattan","1084532","10009","103","42","15","57","9","6.3"
"137 CHRYSTIE STREET","Manhattan","1084898","10002","103","103","1","104","22","4.7"
"516 HUDSON ST","Manhattan","1084957","10014","102","23","1","24","8","3"
"197 7 AVENUE","Manhattan","1084998","10011","104","79","0","79","17","4.6"
"401 WEST   49 STREET","Manhattan","1085042","10019","104","10","0","10","3","3.3"
"1578 3 AVENUE","Manhattan","1085213","10128","108","35","0","35","8","4.4"
"502 WEST  134 STREET","Manhattan","1085358","10031","109","109","5","114","30","3.8"
"71 COOPER STREET","Manhattan","1085686","10034","112","16","0","16","5","3.2"
"57 COOPER STREET","Manhattan","1085693","10034","112","32","0","32","5","6.4"
"19 EAST  117 STREET","Manhattan","1085992","10035","111","18","0","18","3","6"
"1982 2 AVENUE","Manhattan","1087369","10029","111","60","0","60","12","5"
"53 EAST  131 STREET","Manhattan","1087982","10037","111","119","15","134","28","4.8"
"518 WEST  159 STREET","Manhattan","1088115","10032","112","78","1","79","38","2.1"
"148 WEST  143 STREET","Manhattan","1088778","10030","110","105","0","105","34","3.1"
"180 EAST  122 STREET","Manhattan","1088851","10035","111","25","0","25","4","6.3"
"228 WEST  116 STREET","Manhattan","1089849","10026","110","98","3","101","10","10.1"
"143 BRUCKNER BOULEVARD","Bronx","2000019","10454","201","50","2","52","12","4.3"
"492 EAST 138 STREET","Bronx","2000030","10454","201","89","0","89","38","2.3"
"494 EAST 138 STREET","Bronx","2000031","10454","201","107","6","113","21","5.4"
"514 EAST 138 STREET","Bronx","2000036","10454","201","69","0","69","23","3"
"518 EAST 138 STREET","Bronx","2000037","10454","201","159","0","159","23","6.9"
"540 EAST 138 STREET","Bronx","2000044","10454","201","133","2","135","16","8.4"
"542 EAST 138 STREET","Bronx","2000045","10454","201","35","0","35","8","4.4"
"504 BROOK AVENUE","Bronx","2000106","10455","201","103","1","104","18","5.8"
"535 EAST 148 STREET","Bronx","2000129","10455","201","97","0","97","17","5.7"
"401 EAST 136 STREET","Bronx","2000217","10454","201","61","0","61","9","6.8"
"408 EAST  138 STREET","Bronx","2000238","10454","201","78","2","80","7","11.4"
"416 EAST 138 STREET","Bronx","2000241","10454","201","138","0","138","24","5.8"
"403 EAST 139 STREET","Bronx","2000330","10454","201","82","13","95","11","8.6"
"481 EAST 140 STREET","Bronx","2000340","10454","201","55","0","55","11","5"
"441 EAST 140 STREET","Bronx","2000348","10454","201","42","0","42","11","3.8"
"411 EAST 141 STREET","Bronx","2000406","10454","201","78","20","98","13","7.5"
"418 EAST 143 STREET","Bronx","2000419","10454","201","44","2","46","3","15.3"
"408 EAST 144 STREET","Bronx","2000443","10454","201","28","2","30","7","4.3"
"424 EAST 149 STREET","Bronx","2000532","10455","201","62","0","62","8","7.8"
"340 EAST 134 STREET","Bronx","2000552","10454","201","41","0","41","4","10.3"
"43 BRUCKNER BOULEVARD","Bronx","2000576","10454","201","12","0","12","3","4"
"41 BRUCKNER BOULEVARD","Bronx","2000577","10454","201","26","0","26","3","8.7"
"39 BRUCKNER BOULEVARD","Bronx","2000578","10454","201","25","2","27","3","9"
"274 ALEXANDER AVENUE","Bronx","2000585","10454","201","19","10","29","9","3.2"
"378 EAST 139 STREET","Bronx","2000589","10454","201","34","1","35","10","3.5"
"380 EAST 139 STREET","Bronx","2000590","10454","201","43","0","43","10","4.3"
"386 EAST  139 STREET","Bronx","2000591","10454","201","86","3","89","18","4.9"
"237 WILLIS AVENUE","Bronx","2000594","10454","201","61","0","61","8","7.6"
"313 EAST 140 STREET","Bronx","2000745","10454","201","53","4","57","6","9.5"
"2628 3 AVENUE","Bronx","2000748","10454","201","27","1","28","8","3.5"
"341 EAST  146 STREET","Bronx","2000882","10451","201","140","7","147","30","4.9"
"335 EAST  146 STREET","Bronx","2000883","10451","201","106","5","111","28","4"
"286 EAST 149 STREET","Bronx","2000888","10451","201","88","1","89","12","7.4"
"510 EAST 163 STREET","Bronx","2001213","10451","203","26","2","28","7","4"
"1042 WASHINGTON AVENUE","Bronx","2001258","10456","203","58","0","58","3","19.3"
"1048 WASHINGTON AVENUE","Bronx","2001261","10456","203","113","0","113","3","37.7"
"1178 WASHINGTON AVENUE","Bronx","2001313","10456","203","57","0","57","16","3.6"
"425 EAST 153 STREET","Bronx","2001379","10455","201","84","1","85","26","3.3"
"413 EAST 154 STREET","Bronx","2001392","10455","201","38","0","38","6","6.3"
"428 EAST 157 STREET","Bronx","2001423","10451","201","77","0","77","21","3.7"
"419 EAST 157 STREET","Bronx","2001444","10451","201","91","1","92","26","3.5"
"830 ELTON AVENUE","Bronx","2001481","10451","203","64","1","65","21","3.1"
"422 EAST 161 STREET","Bronx","2001493","10451","203","132","6","138","10","13.8"
"426 EAST 162 STREET","Bronx","2001507","10451","203","40","0","40","7","5.7"
"428 EAST 162 STREET","Bronx","2001508","10451","203","33","0","33","9","3.7"
"430 EAST 162 STREET","Bronx","2001509","10451","203","67","1","68","8","8.5"
"922 MELROSE AVENUE","Bronx","2001521","10451","203","24","0","24","8","3"
"628 COURTLANDT AVENUE","Bronx","2001660","10451","201","106","1","107","13","8.2"
"367 EAST  151 STREET","Bronx","2001669","10455","201","63","0","63","8","7.9"
"368 EAST 155 STREET","Bronx","2001710","10455","201","62","0","62","16","3.9"
"386 EAST 155 STREET","Bronx","2001715","10455","201","9","0","9","3","3"
"375 EAST 154 STREET","Bronx","2001725","10455","201","30","0","30","6","5"
"773 MELROSE AVENUE","Bronx","2001746","10451","201","58","0","58","12","4.8"
"304 EAST 151 STREET","Bronx","2001833","10451","201","20","1","21","5","4.2"
"333 EAST 150 STREET","Bronx","2001853","10451","201","354","13","367","35","10.5"
"617 COURTLANDT AVENUE","Bronx","2001879","10451","201","24","0","24","8","3"
"647 COURTLANDT AVENUE","Bronx","2001885","10451","201","11","0","11","3","3.7"
"320 EAST 160 STREET","Bronx","2001902","10451","203","20","0","20","6","3.3"
"280 EAST 162 STREET","Bronx","2001928","10451","204","54","1","55","17","3.2"
"918 MORRIS AVENUE","Bronx","2001951","10451","204","220","1","221","44","5"
"311 EAST 162 STREET","Bronx","2001973","10451","204","14","0","14","3","4.7"
"289 BONNER PLACE","Bronx","2001993","10456","204","32","0","32","9","3.6"
"928 COLLEGE AVENUE","Bronx","2002016","10456","204","98","1","99","17","5.8"
"314 EAST 164 STREET","Bronx","2002025","10456","204","67","9","76","3","25.3"
"351 EAST 163 STREET","Bronx","2002046","10451","204","124","4","128","44","2.9"
"361 EAST 163 STREET","Bronx","2002047","10451","204","174","0","174","59","2.9"
"1046 CLAY AVENUE","Bronx","2002052","10456","204","38","2","40","6","6.7"
"1260 CLAY AVENUE","Bronx","2002098","10456","204","120","0","120","13","9.2"
"1268 CLAY AVENUE","Bronx","2002100","10456","204","73","0","73","12","6.1"
"1272 CLAY AVENUE","Bronx","2002101","10456","204","57","0","57","12","4.8"
"1273 WEBSTER AVENUE","Bronx","2002105","10456","204","46","0","46","10","4.6"
"1047 CLAY AVENUE","Bronx","2002136","10456","204","142","5","147","4","36.8"
"1043 CLAY AVENUE","Bronx","2002138","10456","204","21","0","21","4","5.3"
"371 EAST 165 STREET","Bronx","2002140","10456","204","94","0","94","21","4.5"
"1251 CLAY AVENUE","Bronx","2002176","10456","204","175","0","175","53","3.3"
"312 EAST 165 STREET","Bronx","2002189","10456","204","57","0","57","4","14.3"
"993 FINDLAY AVENUE","Bronx","2002194","10456","204","25","0","25","5","5"
"990 FINDLAY AVENUE","Bronx","2002201","10456","204","16","0","16","3","5.3"
"992 FINDLAY AVENUE","Bronx","2002202","10456","204","73","0","73","3","24.3"
"1056 FINDLAY AVENUE","Bronx","2002224","10456","204","73","0","73","9","8.1"
"1060 FINDLAY AVENUE","Bronx","2002225","10456","204","58","0","58","9","6.4"
"1072 FINDLAY AVENUE","Bronx","2002228","10456","204","30","1","31","9","3.4"
"1081 TELLER AVENUE","Bronx","2002233","10456","204","67","0","67","8","8.4"
"1077 TELLER AVENUE","Bronx","2002234","10456","204","106","1","107","8","13.4"
"1065 TELLER AVENUE","Bronx","2002239","10456","204","11","0","11","3","3.7"
"1059 TELLER AVENUE","Bronx","2002242","10456","204","35","2","37","3","12.3"
"1055 TELLER AVENUE","Bronx","2002244","10456","204","43","0","43","3","14.3"
"1114 COLLEGE AVENUE","Bronx","2002253","10456","204","48","0","48","16","3"
"1142 COLLEGE AVENUE","Bronx","2002258","10456","204","183","0","183","30","6.1"
"1125 FINDLAY AVENUE","Bronx","2002261","10456","204","46","2","48","11","4.4"
"315 EAST 166 STREET","Bronx","2002267","10456","204","78","1","79","20","4"
"1220 COLLEGE AVENUE","Bronx","2002292","10456","204","102","2","104","11","9.5"
"1245 FINDLAY AVENUE","Bronx","2002327","10456","204","315","0","315","67","4.7"
"1062 MORRIS AVENUE","Bronx","2002387","10456","204","9","0","9","3","3"
"1045 COLLEGE AVENUE","Bronx","2002393","10456","204","22","0","22","3","7.3"
"1041 COLLEGE AVENUE","Bronx","2002395","10456","204","45","0","45","3","15"
"1029 COLLEGE AVENUE","Bronx","2002401","10456","204","10","0","10","3","3.3"
"1242 MORRIS AVENUE","Bronx","2002416","10456","204","50","8","58","12","4.8"
"1241 COLLEGE AVENUE","Bronx","2002435","10456","204","25","0","25","3","8.3"
"1237 COLLEGE AVENUE","Bronx","2002436","10456","204","39","1","40","11","3.6"
"225 EAST 163 STREET","Bronx","2002475","10451","204","159","3","162","25","6.5"
"955 GRANT AVENUE","Bronx","2002489","10456","204","106","0","106","6","17.7"
"1007 GRANT AVENUE","Bronx","2002503","10456","204","70","2","72","20","3.6"
"1052 GRANT AVENUE","Bronx","2002534","10456","204","10","16","26","3","8.7"
"1068 GRANT AVENUE","Bronx","2002542","10456","204","12","0","12","3","4"
"1043 MORRIS AVENUE","Bronx","2002558","10456","204","26","0","26","3","8.7"
"1125 MORRIS AVENUE","Bronx","2002576","10456","204","15","0","15","5","3"
"1115 MORRIS AVENUE","Bronx","2002579","10456","204","18","0","18","5","3.6"
"1235 MORRIS AVENUE","Bronx","2002622","10456","204","299","2","301","49","6.1"
"1067 GRANT AVENUE","Bronx","2002631","10456","204","109","0","109","4","27.3"
"1135 GRANT AVENUE","Bronx","2002652","10456","204","24","0","24","3","8"
"1187 GRANT AVENUE","Bronx","2002667","10456","204","10","1","11","3","3.7"
"910 SHERIDAN AVENUE","Bronx","2002705","10451","204","145","2","147","73","2"
"974 SHERIDAN AVENUE","Bronx","2002710","10456","204","197","3","200","48","4.2"
"967 SHERMAN AVENUE","Bronx","2002713","10456","204","147","4","151","20","7.5"
"1081 SHERIDAN AVENUE","Bronx","2002728","10456","204","96","0","96","32","3"
"214 EAST 168 STREET","Bronx","2002770","10456","204","133","0","133","49","2.7"
"1267 SHERIDAN AVENUE","Bronx","2002777","10456","204","277","2","279","67","4.2"
"1183 GRAND CONCOURSE","Bronx","2002844","10452","204","140","9","149","59","2.5"
"1215 GRAND CONCOURSE","Bronx","2002847","10452","204","145","9","154","48","3.2"
"105 EAST 168 STREET","Bronx","2002856","10452","204","367","6","373","46","8.1"
"1055 GRAND CONCOURSE","Bronx","2002890","10452","204","152","0","152","55","2.8"
"751 WALTON AVENUE","Bronx","2002896","10451","204","240","5","245","100","2.5"
"910 GERARD AVENUE","Bronx","2002922","10452","204","30","1","31","6","5.2"
"1097 WALTON AVENUE","Bronx","2002950","10452","204","450","1","451","62","7.3"
"1170 GERARD AVENUE","Bronx","2002956","10452","204","194","1","195","54","3.6"
"1173 WALTON AVENUE","Bronx","2002960","10452","204","305","1","306","64","4.8"
"705 GERARD AVENUE","Bronx","2002973","10451","204","154","7","161","73","2.2"
"691 GERARD AVENUE","Bronx","2002974","10451","204","126","4","130","65","2"
"1265 GERARD AVENUE","Bronx","2003014","10452","204","122","0","122","54","2.3"
"974 ANDERSON AVENUE","Bronx","2003048","10452","204","57","1","58","9","6.4"
"1055 JEROME AVENUE","Bronx","2003053","10452","204","132","7","139","63","2.2"
"1088 ANDERSON AVENUE","Bronx","2003057","10452","204","121","0","121","41","3"
"1220 SHAKESPEARE AVENUE","Bronx","2003078","10452","204","144","0","144","61","2.4"
"1234 SHAKESPEARE AVENUE","Bronx","2003081","10452","204","87","0","87","38","2.3"
"1300 SHAKESPEARE AVENUE","Bronx","2003097","10452","204","14","0","14","3","4.7"
"985 ANDERSON AVENUE","Bronx","2003121","10452","204","131","0","131","50","2.6"
"74 WEST 165 STREET","Bronx","2003140","10452","204","138","7","145","19","7.6"
"1230 WOODYCREST AVENUE","Bronx","2003160","10452","204","121","4","125","41","3"
"934 OGDEN AVENUE","Bronx","2003178","10452","204","52","0","52","16","3.3"
"1016 OGDEN AVENUE","Bronx","2003201","10452","204","9","0","9","3","3"
"1020 OGDEN AVENUE","Bronx","2003203","10452","204","45","5","50","3","16.7"
"1019 NELSON AVENUE","Bronx","2003219","10452","204","33","0","33","3","11"
"1001 WOODYCREST AVENUE","Bronx","2003224","10452","204","174","4","178","61","2.9"
"1023 WOODYCREST AVENUE","Bronx","2003234","10452","204","52","0","52","3","17.3"
"1061 WOODYCREST AVENUE","Bronx","2003246","10452","204","283","0","283","54","5.2"
"1075 NELSON AVENUE","Bronx","2003262","10452","204","125","2","127","38","3.3"
"1140 OGDEN AVENUE","Bronx","2003265","10452","204","128","0","128","48","2.7"
"122 WEST 167 STREET","Bronx","2003271","10452","204","43","0","43","4","10.8"
"1360 OGDEN AVENUE","Bronx","2003376","10452","204","232","14","246","35","7"
"1372 OGDEN AVENUE","Bronx","2003377","10452","204","84","0","84","20","4.2"
"1376 OGDEN AVENUE","Bronx","2003378","10452","204","90","0","90","26","3.5"
"1380 OGDEN AVENUE","Bronx","2003379","10452","204","86","0","86","20","4.3"
"1386 OGDEN AVENUE","Bronx","2003380","10452","204","88","0","88","20","4.4"
"1390 OGDEN AVENUE","Bronx","2003381","10452","204","103","1","104","24","4.3"
"1345 PLIMPTON AVENUE","Bronx","2003404","10452","204","73","0","73","24","3"
"903 SUMMIT AVENUE","Bronx","2003406","10452","204","136","14","150","43","3.5"
"909 SUMMIT AVENUE","Bronx","2003408","10452","204","0","9","9","3","3"
"1027 SUMMIT AVENUE","Bronx","2003418","10452","204","8","5","13","3","4.3"
"989 SUMMIT AVENUE","Bronx","2003432","10452","204","66","0","66","8","8.3"
"947 OGDEN AVENUE","Bronx","2003441","10452","204","81","0","81","24","3.4"
"1018 SUMMIT AVENUE","Bronx","2003457","10452","204","125","7","132","35","3.8"
"1046 SUMMIT AVENUE","Bronx","2003463","10452","204","24","0","24","4","6"
"1201 UNIVERSITY AVENUE","Bronx","2003513","10452","204","98","4","102","38","2.7"
"1344 UNIVERSITY AVENUE","Bronx","2003533","10452","204","121","0","121","51","2.4"
"151 BRUCKNER BOULEVARD","Bronx","2003597","10454","201","31","7","38","12","3.2"
"626 EAST 140 STREET","Bronx","2003642","10454","201","68","2","70","11","6.4"
"344 BEEKMAN AVENUE","Bronx","2003660","10454","201","160","3","163","57","2.9"
"612 BEECH TERRACE","Bronx","2003683","10454","201","34","0","34","3","11.3"
"674 EAST 138 STREET","Bronx","2003789","10454","201","83","0","83","15","5.5"
"231 JACKSON AVENUE","Bronx","2003793","10454","201","47","0","47","15","3.1"
"683 EAST 140 STREET","Bronx","2003821","10454","201","177","2","179","72","2.5"
"349 CONCORD AVENUE","Bronx","2003846","10454","201","74","0","74","3","24.7"
"511 CONCORD AVENUE","Bronx","2003933","10455","201","13","0","13","3","4.3"
"800 EAST 149 STREET","Bronx","2003957","10455","201","78","1","79","16","4.9"
"533 TINTON AVENUE","Bronx","2003959","10455","201","64","0","64","21","3"
"1071 FRANKLIN AVENUE","Bronx","2004195","10456","203","133","0","133","25","5.3"
"3414 3 AVENUE","Bronx","2004202","10456","203","39","0","39","10","3.9"
"530 EAST 169 STREET","Bronx","2004223","10456","203","781","44","825","321","2.6"
"1234 FULTON AVENUE","Bronx","2004243","10456","203","34","0","34","8","4.3"
"1122 FRANKLIN AVENUE","Bronx","2004260","10456","203","0","32","32","10","3.2"
"1133 BOSTON ROAD","Bronx","2004268","10456","203","254","1","255","51","5"
"614 EAST 168 STREET","Bronx","2004281","10456","203","98","0","98","8","12.3"
"670 ST ANNS AVENUE","Bronx","2004322","10455","201","57","0","57","10","5.7"
"674 ST ANNS AVENUE","Bronx","2004323","10455","201","67","1","68","9","7.6"
"678 ST ANNS AVENUE","Bronx","2004324","10455","201","25","3","28","9","3.1"
"711 EAGLE AVENUE","Bronx","2004335","10455","201","17","0","17","3","5.7"
"707 EAGLE AVENUE","Bronx","2004336","10455","201","33","0","33","3","11"
"635 EAGLE AVENUE","Bronx","2004347","10455","201","14","0","14","3","4.7"
"3194 3 AVENUE","Bronx","2004361","10451","203","58","2","60","6","10"
"3198 3 AVENUE","Bronx","2004363","10451","203","15","0","15","4","3.8"
"3206 3 AVENUE","Bronx","2004367","10451","203","81","22","103","6","17.2"
"917 EAGLE AVENUE","Bronx","2004381","10456","203","60","0","60","16","3.8"
"594 EAGLE AVENUE","Bronx","2004410","10455","201","3","16","19","5","3.8"
"563 CAULDWELL AVENUE","Bronx","2004411","10455","201","135","4","139","49","2.8"
"898 EAGLE AVENUE","Bronx","2004479","10456","203","29","0","29","5","5.8"
"786 CAULDWELL AVENUE","Bronx","2004490","10456","201","27","0","27","3","9"
"1064 CAULDWELL AVENUE","Bronx","2004502","10456","203","131","0","131","48","2.7"
"763 JACKSON AVENUE","Bronx","2004530","10456","201","28","0","28","4","7"
"1118 JACKSON AVENUE","Bronx","2004613","10456","203","54","6","60","3","20"
"1143 FOREST AVENUE","Bronx","2004626","10456","203","9","0","9","3","3"
"1125 FOREST AVENUE","Bronx","2004635","10456","203","15","0","15","3","5"
"1114 JACKSON AVENUE","Bronx","2004650","10456","203","40","7","47","3","15.7"
"609 TINTON AVENUE","Bronx","2004671","10455","201","28","0","28","7","4"
"1126 FOREST AVENUE","Bronx","2004705","10456","203","34","0","34","3","11.3"
"1105 TINTON AVENUE","Bronx","2004707","10456","203","95","2","97","45","2.2"
"1221 TINTON AVENUE","Bronx","2004763","10456","203","5","4","9","3","3"
"1233 UNION AVENUE","Bronx","2004887","10459","203","22","0","22","3","7.3"
"1212 TINTON AVENUE","Bronx","2004894","10456","203","12","0","12","3","4"
"606 UNION AVENUE","Bronx","2004903","10455","201","13","0","13","4","3.3"
"597 PROSPECT AVENUE","Bronx","2004909","10455","201","20","0","20","5","4"
"676 UNION AVENUE","Bronx","2004923","10455","201","184","0","184","8","23"
"834 EAST 155 STREET","Bronx","2004931","10455","201","33","0","33","8","4.1"
"733 PROSPECT AVENUE","Bronx","2004957","10455","201","95","1","96","17","5.6"
"725 PROSPECT AVENUE","Bronx","2004960","10455","201","9","0","9","3","3"
"721 PROSPECT AVENUE","Bronx","2004962","10455","201","13","0","13","3","4.3"
"785 UNION AVENUE","Bronx","2004976","10455","201","42","0","42","10","4.2"
"753 UNION AVENUE","Bronx","2004980","10455","201","24","0","24","4","6"
"803 EAST 156 STREET","Bronx","2004983","10455","201","15","0","15","4","3.8"
"770 UNION AVENUE","Bronx","2004984","10455","201","45","0","45","8","5.6"
"830 EAST 163 STREET","Bronx","2005012","10459","203","130","16","146","37","3.9"
"812 EAST 165 STREET","Bronx","2005017","10459","203","0","136","136","4","34"
"832 EAST 165 STREET","Bronx","2005022","10459","203","19","0","19","3","6.3"
"1315 PROSPECT AVENUE","Bronx","2005051","10459","203","143","0","143","15","9.5"
"827 HOME STREET","Bronx","2005055","10459","203","62","0","62","20","3.1"
"823 HOME STREET","Bronx","2005056","10459","203","48","1","49","15","3.3"
"822 EAST 169 STREET","Bronx","2005070","10459","203","6","3","9","3","3"
"944 LEGGETT AVENUE","Bronx","2005108","10455","202","27","0","27","9","3"
"954 LEGGETT AVENUE","Bronx","2005111","10455","202","38","0","38","8","4.8"
"673 BECK STREET","Bronx","2005119","10455","202","80","0","80","8","10"
"923 AVENUE ST JOHN","Bronx","2005125","10455","202","48","0","48","8","6"
"919 AVENUE ST JOHN","Bronx","2005126","10455","202","25","0","25","8","3.1"
"903 AVENUE ST JOHN","Bronx","2005131","10455","202","47","0","47","4","11.8"
"663 DAWSON STREET","Bronx","2005138","10455","202","21","1","22","3","7.3"
"870 LONGWOOD AVENUE","Bronx","2005171","10459","202","117","0","117","11","10.6"
"857 MACY PLACE","Bronx","2005183","10455","202","102","2","104","3","34.7"
"870 EAST  163 STREET","Bronx","2005202","10459","202","41","0","41","3","13.7"
"856 EAST 165 STREET","Bronx","2005216","10459","202","9","0","9","3","3"
"867 EAST  164 STREET","Bronx","2005220","10459","202","16","0","16","3","5.3"
"866 EAST 164 STREET","Bronx","2005230","10459","202","68","1","69","4","17.3"
"1044 PROSPECT AVENUE","Bronx","2005242","10459","202","108","0","108","4","27"
"1023 STEBBINS AVENUE","Bronx","2005248","10459","202","40","0","40","12","3.3"
"1226 PROSPECT AVENUE","Bronx","2005300","10459","202","54","0","54","11","4.9"
"1251 STEBBINS AVENUE","Bronx","2005311","10459","202","11","0","11","3","3.7"
"907 EAST 156 STREET","Bronx","2005338","10455","202","0","11","11","3","3.7"
"814 HEWITT PLACE","Bronx","2005344","10459","202","37","0","37","10","3.7"
"940 STEBBINS AVENUE","Bronx","2005360","10459","202","58","0","58","4","14.5"
"941 ROGERS PLACE","Bronx","2005367","10459","202","86","0","86","22","3.9"
"745 KELLY STREET","Bronx","2005441","10455","202","20","0","20","3","6.7"
"957 KELLY STREET","Bronx","2005462","10459","202","240","0","240","41","5.9"
"1006 INTERVALE AVENUE","Bronx","2005470","10459","202","67","0","67","19","3.5"
"918 EAST 165 STREET","Bronx","2005472","10459","202","20","0","20","4","5"
"1074 INTERVALE AVENUE","Bronx","2005485","10459","202","13","0","13","3","4.3"
"1137 TIFFANY STREET","Bronx","2005505","10459","202","21","0","21","4","5.3"
"776 BECK STREET","Bronx","2005534","10455","202","12","0","12","3","4"
"958 EAST  156 STREET","Bronx","2005547","10455","202","38","0","38","3","12.7"
"719 BECK STREET","Bronx","2005555","10455","202","17","0","17","3","5.7"
"740 KELLY STREET","Bronx","2005559","10455","202","143","21","164","4","41"
"826 BECK STREET","Bronx","2005592","10459","202","31","1","32","9","3.6"
"838 BECK STREET","Bronx","2005595","10459","202","34","0","34","9","3.8"
"877 INTERVALE AVENUE","Bronx","2005603","10459","202","139","0","139","8","17.4"
"827 FOX STREET","Bronx","2005611","10459","202","24","1","25","7","3.6"
"928 KELLY STREET","Bronx","2005621","10459","202","37","0","37","8","4.6"
"1086 KELLY STREET","Bronx","2005673","10459","202","61","0","61","16","3.8"
"1049 FOX STREET","Bronx","2005682","10459","202","90","28","118","42","2.8"
"1020 TIFFANY STREET","Bronx","2005688","10459","202","31","1","32","10","3.2"
"1120 FOX STREET","Bronx","2005701","10459","203","40","1","41","11","3.7"
"1122 FOX STREET","Bronx","2005702","10459","203","43","0","43","4","10.8"
"1124 FOX STREET","Bronx","2005718","10459","203","1","90","91","4","22.8"
"923 SIMPSON STREET","Bronx","2005759","10459","202","91","3","94","43","2.2"
"906 SIMPSON STREET","Bronx","2005761","10459","202","108","0","108","31","3.5"
"1023 SOUTHERN BOULEVARD","Bronx","2005775","10459","202","28","0","28","9","3.1"
"1007 SOUTHERN BOULEVARD","Bronx","2005779","10459","202","34","0","34","11","3.1"
"1076 FOX STREET","Bronx","2005795","10459","202","80","0","80","3","26.7"
"1018 FOX STREET","Bronx","2005800","10459","202","20","0","20","3","6.7"
"925 BRUCKNER BOULEVARD","Bronx","2005868","10459","202","10","4","14","3","4.7"
"919 BRUCKNER BOULEVARD","Bronx","2005870","10459","202","22","0","22","3","7.3"
"949 BRUCKNER BOULEVARD","Bronx","2005890","10459","202","10","0","10","3","3.3"
"945 BRUCKNER BOULEVARD","Bronx","2005891","10459","202","70","0","70","21","3.3"
"875 HUNTS POINT AVENUE","Bronx","2005943","10474","202","60","2","62","8","7.8"
"1275 LAFAYETTE AVENUE","Bronx","2005958","10474","202","87","1","88","41","2.1"
"1163 HOE AVENUE","Bronx","2006063","10459","203","63","0","63","10","6.3"
"1161 HOE AVENUE","Bronx","2006064","10459","203","120","4","124","10","12.4"
"1014 FAILE STREET","Bronx","2006085","10459","202","9","0","9","3","3"
"1018 FAILE STREET","Bronx","2006087","10459","202","15","0","15","3","5"
"1020 FAILE STREET","Bronx","2006088","10459","202","18","0","18","3","6"
"1022 FAILE STREET","Bronx","2006089","10459","202","15","0","15","3","5"
"1030 FAILE STREET","Bronx","2006093","10459","202","10","0","10","3","3.3"
"1036 FAILE STREET","Bronx","2006096","10459","202","10","0","10","3","3.3"
"1043 FAILE STREET","Bronx","2006119","10459","202","21","1","22","6","3.7"
"1021 FAILE STREET","Bronx","2006130","10459","202","26","1","27","6","4.5"
"1206 WESTCHESTER AVENUE","Bronx","2006148","10459","202","422","8","430","104","4.1"
"1175 VYSE AVENUE","Bronx","2006173","10459","203","25","1","26","8","3.3"
"1173 VYSE AVENUE","Bronx","2006174","10459","203","51","0","51","8","6.4"
"1137 VYSE AVENUE","Bronx","2006178","10459","203","9","1","10","3","3.3"
"1151 LONGFELLOW AVENUE","Bronx","2006196","10459","203","30","0","30","3","10"
"1145 LONGFELLOW AVENUE","Bronx","2006197","10459","203","79","0","79","26","3"
"1120 BRYANT AVENUE","Bronx","2006204","10459","203","105","0","105","11","9.5"
"1146 BRYANT AVENUE","Bronx","2006209","10459","203","49","0","49","8","6.1"
"1045 LONGFELLOW AVENUE","Bronx","2006231","10459","202","12","0","12","4","3"
"1030 LONGFELLOW AVENUE","Bronx","2006258","10459","202","24","0","24","4","6"
"1036 LONGFELLOW AVENUE","Bronx","2006261","10459","202","25","0","25","4","6.3"
"1054 LONGFELLOW AVENUE","Bronx","2006268","10459","202","33","0","33","4","8.3"
"1083 LONGFELLOW AVENUE","Bronx","2006278","10459","202","148","0","148","45","3.3"
"1038 LOWELL STREET","Bronx","2006280","10459","202","44","0","44","11","4"
"1050 LOWELL STREET","Bronx","2006282","10459","202","133","0","133","11","12.1"
"1155 EAST 165 STREET","Bronx","2006284","10459","202","55","0","55","11","5"
"1094 LONGFELLOW AVENUE","Bronx","2006288","10459","202","80","1","81","4","20.3"
"1043 LOWELL STREET","Bronx","2006298","10459","202","38","0","38","4","9.5"
"1150 LONGFELLOW AVENUE","Bronx","2006307","10459","203","38","6","44","3","14.7"
"917 BRYANT AVENUE","Bronx","2006370","10474","202","37","0","37","6","6.2"
"915 BRYANT AVENUE","Bronx","2006371","10474","202","27","7","34","4","8.5"
"906 BRYANT AVENUE","Bronx","2006391","10474","202","60","0","60","3","20"
"912 BRYANT AVENUE","Bronx","2006393","10474","202","9","0","9","3","3"
"813 FAILE STREET","Bronx","2006430","10474","202","67","1","68","10","6.8"
"855 FAILE STREET","Bronx","2006442","10474","202","0","10","10","3","3.3"
"828 FAILE STREET","Bronx","2006451","10474","202","9","41","50","4","12.5"
"830 FAILE STREET","Bronx","2006452","10474","202","34","0","34","4","8.5"
"858 FAILE STREET","Bronx","2006458","10474","202","9","8","17","4","4.3"
"801 BRYANT AVENUE","Bronx","2006470","10474","202","336","1","337","38","8.9"
"1261 SPOFFORD AVENUE","Bronx","2006512","10474","202","171","0","171","3","57"
"754 MANIDA STREET","Bronx","2006524","10474","202","278","9","287","38","7.6"
"741 HUNTS POINT AVENUE","Bronx","2006531","10474","202","131","10","141","56","2.5"
"735 BRYANT AVENUE","Bronx","2006556","10474","202","159","2","161","49","3.3"
"750 BRYANT AVENUE","Bronx","2006567","10474","202","149","3","152","61","2.5"
"1202 SPOFFORD AVENUE","Bronx","2006595","10474","202","272","25","297","60","5"
"643 BARRETTO STREET","Bronx","2006614","10474","202","32","0","32","5","6.4"
"620 MANIDA STREET","Bronx","2006661","10474","202","37","0","37","9","4.1"
"648 MANIDA STREET","Bronx","2006671","10474","202","14","0","14","3","4.7"
"662 MANIDA STREET","Bronx","2006677","10474","202","32","0","32","3","10.7"
"640 BARRETTO STREET","Bronx","2006679","10474","202","41","0","41","4","10.3"
"617 FAILE STREET","Bronx","2006690","10474","202","13","0","13","3","4.3"
"651 BRYANT AVENUE","Bronx","2006710","10474","202","9","0","9","3","3"
"632 COSTER STREET","Bronx","2006749","10474","202","12","0","12","3","4"
"541 COSTER STREET","Bronx","2006815","10474","202","34","1","35","6","5.8"
"1357 TELLER AVENUE","Bronx","2007066","10456","204","28","0","28","5","5.6"
"1302 COLLEGE AVENUE","Bronx","2007174","10456","204","20","2","22","7","3.1"
"1306 COLLEGE AVENUE","Bronx","2007175","10456","204","112","1","113","26","4.3"
"1359 FINDLAY AVENUE","Bronx","2007201","10456","204","39","1","40","11","3.6"
"1355 FINDLAY AVENUE","Bronx","2007202","10456","204","33","1","34","11","3.1"
"309 EAST  170 STREET","Bronx","2007251","10456","204","120","0","120","3","40"
"307 EAST  170 STREET","Bronx","2007252","10456","204","21","0","21","4","5.3"
"305 EAST 170 STREET","Bronx","2007253","10456","204","44","0","44","5","8.8"
"1323 COLLEGE AVENUE","Bronx","2007286","10456","204","61","0","61","20","3"
"1311 COLLEGE AVENUE","Bronx","2007287","10456","204","157","1","158","26","6.1"
"346 EAST 173 STREET","Bronx","2007315","10457","204","67","0","67","20","3.4"
"1654 MONROE AVENUE","Bronx","2007333","10457","204","164","2","166","49","3.4"
"1696 MONROE AVENUE","Bronx","2007347","10457","204","19","1","20","3","6.7"
"1685 TOPPING AVENUE","Bronx","2007354","10457","204","188","2","190","43","4.4"
"1665 MONROE AVENUE","Bronx","2007359","10457","204","207","1","208","49","4.2"
"1774 EASTBURN AVENUE","Bronx","2007422","10457","205","129","2","131","41","3.2"
"150 EAST 175 STREET","Bronx","2007424","10457","205","66","0","66","15","4.4"
"1748 MONROE AVENUE","Bronx","2007461","10457","205","35","0","35","6","5.8"
"1754 MONROE AVENUE","Bronx","2007463","10457","205","9","0","9","3","3"
"1760 TOPPING AVENUE","Bronx","2007491","10457","205","10","0","10","3","3.3"
"274 EAST 175 STREET","Bronx","2007501","10457","205","94","0","94","43","2.2"
"1822 MONROE AVENUE","Bronx","2007518","10457","205","134","14","148","30","4.9"
"1821 TOPPING AVENUE","Bronx","2007522","10457","205","266","0","266","3","88.7"
"273 EAST 175 STREET","Bronx","2007538","10457","205","90","1","91","45","2"
"1855 MONROE AVENUE","Bronx","2007545","10457","205","100","10","110","37","3"
"240 EAST TREMONT AVENUE","Bronx","2007600","10457","205","50","0","50","6","8.3"
"110 EAST 177 STREET","Bronx","2007626","10453","205","166","7","173","55","3.1"
"1895 GRAND CONCOURSE","Bronx","2007630","10453","205","61","0","61","15","4.1"
"1881 GRAND CONCOURSE","Bronx","2007631","10453","205","76","1","77","17","4.5"
"1990 MORRIS AVENUE","Bronx","2007648","10453","205","11","0","11","3","3.7"
"1986 MORRIS AVENUE","Bronx","2007678","10453","205","18","0","18","3","6"
"156 EAST 178 STREET","Bronx","2007682","10453","205","118","2","120","36","3.3"
"255 EAST TREMONT AVENUE","Bronx","2007715","10457","205","37","1","38","3","12.7"
"245 EAST 178 STREET","Bronx","2007732","10457","205","132","6","138","55","2.5"
"1355 MORRIS AVENUE","Bronx","2007793","10456","204","104","0","104","45","2.3"
"1515 SELWYN AVENUE","Bronx","2007821","10457","204","87","22","109","47","2.3"
"1692 GRAND CONCOURSE","Bronx","2007861","10457","204","78","0","78","26","3"
"1770 WALTON AVENUE","Bronx","2007880","10453","205","196","2","198","38","5.2"
"1780 WALTON AVENUE","Bronx","2007881","10453","205","31","0","31","9","3.4"
"124 EAST 176 STREET","Bronx","2007883","10453","205","146","6","152","71","2.1"
"1777 GRAND CONCOURSE","Bronx","2007890","10453","205","428","5","433","167","2.6"
"1890 WALTON AVENUE","Bronx","2007904","10453","205","65","0","65","8","8.1"
"1926 WALTON AVENUE","Bronx","2007911","10453","205","147","0","147","26","5.7"
"1967 MORRIS AVENUE","Bronx","2007939","10453","205","49","0","49","15","3.3"
"55 EAST 179 STREET","Bronx","2007941","10453","205","145","0","145","33","4.4"
"2027 MORRIS AVENUE","Bronx","2007950","10453","205","8","25","33","4","8.3"
"1310 SHERIDAN AVENUE","Bronx","2007964","10456","204","171","2","173","79","2.2"
"1314 GRAND CONCOURSE","Bronx","2007973","10456","204","101","0","101","40","2.5"
"1410 GRAND CONCOURSE","Bronx","2007987","10456","204","184","4","188","35","5.4"
"1454 GRAND CONCOURSE","Bronx","2007991","10457","204","155","4","159","58","2.7"
"1466 GRAND CONCOURSE","Bronx","2007993","10457","204","268","0","268","58","4.6"
"1455 GRAND CONCOURSE","Bronx","2008006","10452","204","45","17","62","17","3.6"
"1515 GRAND CONCOURSE","Bronx","2008009","10452","204","261","2","263","76","3.5"
"125 EAST  169 STREET","Bronx","2008039","10452","204","11","8","19","3","6.3"
"123 EAST 169 STREET","Bronx","2008040","10452","204","12","0","12","3","4"
"115 EAST 169 STREET","Bronx","2008042","10452","204","89","0","89","37","2.4"
"20 EAST MT EDEN AVENUE","Bronx","2008140","10452","204","182","0","182","47","3.9"
"1775 WALTON AVENUE","Bronx","2008216","10453","205","132","26","158","63","2.5"
"65 EAST 175 STREET","Bronx","2008217","10453","205","165","5","170","49","3.5"
"69 EAST 176 STREET","Bronx","2008226","10453","205","381","2","383","44","8.7"
"19 EAST 176 STREET","Bronx","2008229","10453","205","68","0","68","4","17"
"1881 WALTON AVENUE","Bronx","2008239","10453","205","356","0","356","35","10.2"
"1485 MACOMBS ROAD","Bronx","2008301","10452","204","144","21","165","49","3.4"
"1726 DAVIDSON AVENUE","Bronx","2008361","10453","205","229","2","231","74","3.1"
"1331 INWOOD AVENUE","Bronx","2008413","10452","204","10","0","10","3","3.3"
"24 WEST 174 STREET","Bronx","2008442","10453","205","56","0","56","9","6.2"
"1630 MACOMBS ROAD","Bronx","2008447","10453","205","136","5","141","52","2.7"
"1631 GRAND AVENUE","Bronx","2008451","10453","205","140","4","144","42","3.4"
"1640 GRAND AVENUE","Bronx","2008477","10453","205","122","0","122","5","24.4"
"1692 GRAND AVENUE","Bronx","2008494","10453","205","19","0","19","5","3.8"
"1735 DAVIDSON AVENUE","Bronx","2008498","10453","205","81","0","81","18","4.5"
"1962 UNIVERSITY AVENUE","Bronx","2008550","10453","205","35","2","37","11","3.4"
"1966 UNIVERSITY AVENUE","Bronx","2008551","10453","205","46","2","48","11","4.4"
"1970 UNIVERSITY AVENUE","Bronx","2008552","10453","205","110","1","111","21","5.3"
"1974 UNIVERSITY AVENUE","Bronx","2008553","10453","205","89","14","103","11","9.4"
"2015 GRAND AVENUE","Bronx","2008611","10453","205","228","4","232","31","7.5"
"1432 SHAKESPEARE AVENUE","Bronx","2008671","10452","204","27","1","28","4","7"
"1540 JESUP AVENUE","Bronx","2008704","10452","204","24","0","24","4","6"
"1713 NELSON AVENUE","Bronx","2008839","10453","205","240","4","244","49","5"
"1672 NELSON AVENUE","Bronx","2008846","10453","205","27","0","27","3","9"
"81 WEST 174 STREET","Bronx","2008862","10453","205","38","0","38","3","12.7"
"1639 NELSON AVENUE","Bronx","2008870","10453","205","25","0","25","5","5"
"1637 NELSON AVENUE","Bronx","2008871","10453","205","22","0","22","6","3.7"
"1764 POPHAM AVENUE","Bronx","2008935","10453","205","27","0","27","6","4.5"
"1812 PALISADE PLACE","Bronx","2008975","10453","205","11","11","22","3","7.3"
"1668 MONTGOMERY AVENUE","Bronx","2009000","10453","205","12","3","15","5","3"
"1815 UNIVERSITY AVENUE","Bronx","2009098","10453","205","140","3","143","26","5.5"
"1805 UNIVERSITY AVENUE","Bronx","2009099","10453","205","244","0","244","26","9.4"
"1883 BILLINGSLEY TERRACE","Bronx","2009105","10453","205","9","0","9","3","3"
"1898 BILLINGSLEY TERRACE","Bronx","2009149","10453","205","104","13","117","26","4.5"
"1809 PHELAN PLACE","Bronx","2009158","10453","205","104","0","104","23","4.5"
"1808 CEDAR AVENUE","Bronx","2009226","10453","205","119","0","119","36","3.3"
"1304 CLAY AVENUE","Bronx","2009259","10456","204","12","0","12","3","4"
"1324 CLAY AVENUE","Bronx","2009266","10456","204","44","0","44","3","14.7"
"1398 CLAY AVENUE","Bronx","2009295","10456","204","141","6","147","25","5.9"
"1361 WEBSTER AVENUE","Bronx","2009304","10456","204","36","1","37","8","4.6"
"1357 WEBSTER AVENUE","Bronx","2009306","10456","204","30","0","30","8","3.8"
"1704 ANTHONY AVENUE","Bronx","2009335","10457","204","14","6","20","4","5"
"1818 CLAY AVENUE","Bronx","2009360","10457","205","89","2","91","24","3.8"
"344 EAST 176 STREET","Bronx","2009376","10457","205","27","0","27","8","3.4"
"481 EAST 171 STREET","Bronx","2009543","10457","203","76","0","76","14","5.4"
"1514 WASHINGTON AVENUE","Bronx","2009544","10457","203","44","0","44","11","4"
"501 EAST 176 STREET","Bronx","2009599","10457","206","44","2","46","6","7.7"
"3716 3 AVENUE","Bronx","2009625","10456","203","188","7","195","41","4.8"
"595 EAST 170 STREET","Bronx","2009719","10456","203","176","2","178","84","2.1"
"644 EAST 170 STREET","Bronx","2009771","10456","203","38","0","38","9","4.2"
"1397 CROTONA AVENUE","Bronx","2009783","10456","203","11","0","11","3","3.7"
"665 JEFFERSON PLACE","Bronx","2009793","10456","203","0","16","16","3","5.3"
"621 EAST 170 STREET","Bronx","2009800","10456","203","36","0","36","10","3.6"
"1451 PROSPECT AVENUE","Bronx","2009825","10456","203","132","2","134","22","6.1"
"1431 PROSPECT AVENUE","Bronx","2009831","10456","203","29","3","32","9","3.6"
"689 EAST 170 STREET","Bronx","2009834","10456","203","10","0","10","3","3.3"
"1404 CROTONA PARK EAST","Bronx","2009839","10460","203","41","1","42","3","14"
"1660 CROTONA PARK EAST","Bronx","2009870","10460","203","368","4","372","67","5.6"
"819 EAST 173 STREET","Bronx","2009884","10460","203","145","5","150","71","2.1"
"1898 BELMONT AVENUE","Bronx","2009895","10457","206","90","0","90","21","4.3"
"1908 BELMONT AVENUE","Bronx","2009897","10457","206","142","0","142","52","2.7"
"1888 ARTHUR AVENUE","Bronx","2009908","10457","206","65","0","65","20","3.3"
"710 EAST 175 STREET","Bronx","2009917","10457","206","211","2","213","8","26.6"
"1820 CROTONA AVENUE","Bronx","2009946","10457","206","30","0","30","3","10"
"1818 CLINTON AVENUE","Bronx","2009952","10457","206","9","0","9","3","3"
"1904 CROTONA AVENUE","Bronx","2009966","10457","206","53","0","53","8","6.6"
"1790 PROSPECT AVENUE","Bronx","2010006","10457","206","75","2","77","4","19.3"
"1908 PROSPECT AVENUE","Bronx","2010030","10457","206","77","4","81","21","3.9"
"1912 PROSPECT AVENUE","Bronx","2010031","10457","206","229","0","229","21","10.9"
"815 FAIRMOUNT PLACE","Bronx","2010048","10460","206","146","8","154","48","3.2"
"805 FAIRMOUNT PLACE","Bronx","2010049","10460","206","82","0","82","35","2.3"
"793 FAIRMOUNT PLACE","Bronx","2010050","10460","206","248","1","249","26","9.6"
"887 CROTONA PARK NORTH","Bronx","2010091","10460","206","94","5","99","30","3.3"
"861 CROTONA PARK NORTH","Bronx","2010092","10460","206","53","1","54","16","3.4"
"870 EAST 175 STREET","Bronx","2010103","10460","206","150","1","151","19","7.9"
"1811 WATERLOO PLACE","Bronx","2010128","10460","206","166","0","166","10","16.6"
"771 EAST 169 STREET","Bronx","2010167","10456","203","17","0","17","3","5.7"
"1295 UNION AVENUE","Bronx","2010175","10459","203","48","0","48","12","4"
"1378 BOSTON ROAD","Bronx","2010188","10456","203","71","2","73","14","5.2"
"1384 BOSTON ROAD","Bronx","2010189","10456","203","76","1","77","14","5.5"
"1417 PROSPECT AVENUE","Bronx","2010200","10459","203","169","5","174","21","8.3"
"741 JENNINGS STREET","Bronx","2010207","10459","203","47","0","47","15","3.1"
"797 JENNINGS STREET","Bronx","2010229","10459","203","55","0","55","3","18.3"
"1384 BRISTOW STREET","Bronx","2010247","10459","203","88","1","89","21","4.2"
"1555 SEABURY PLACE","Bronx","2010300","10460","203","88","43","131","50","2.6"
"851 EAST 169 STREET","Bronx","2010347","10459","203","52","0","52","10","5.2"
"1338 PROSPECT AVENUE","Bronx","2010348","10459","203","22","0","22","3","7.3"
"1348 PROSPECT AVENUE","Bronx","2010353","10459","203","10","0","10","3","3.3"
"820 FREEMAN STREET","Bronx","2010358","10459","203","23","3","26","3","8.7"
"1330 CHISHOLM STREET","Bronx","2010423","10459","203","19","1","20","3","6.7"
"1302 STEBBINS AVENUE","Bronx","2010450","10459","203","206","0","206","8","25.8"
"1234 INTERVALE AVENUE","Bronx","2010459","10459","203","0","81","81","3","27"
"918 FREEMAN STREET","Bronx","2010476","10459","203","75","0","75","10","7.5"
"907 EAST 173 STREET","Bronx","2010529","10460","203","108","0","108","16","6.8"
"1228 SOUTHERN BOULEVARD","Bronx","2010536","10459","203","58","0","58","8","7.3"
"1460 SOUTHERN BOULEVARD","Bronx","2010568","10460","203","77","2","79","5","15.8"
"936 EAST 172 STREET","Bronx","2010574","10460","203","62","0","62","10","6.2"
"932 EAST 173 STREET","Bronx","2010594","10460","203","66","6","72","18","4"
"937 EAST 172 STREET","Bronx","2010598","10460","203","46","4","50","10","5"
"1890 CROTONA PARKWAY","Bronx","2010617","10460","206","115","0","115","39","2.9"
"1300 HOE AVENUE","Bronx","2010641","10459","203","64","0","64","21","3"
"1529 VYSE AVENUE","Bronx","2010667","10460","203","14","0","14","3","4.7"
"1531 VYSE AVENUE","Bronx","2010669","10460","203","9","0","9","3","3"
"1892 DALY AVENUE","Bronx","2010690","10460","206","81","0","81","3","27"
"1001 HOME STREET","Bronx","2010716","10459","203","101","0","101","26","3.9"
"1490 VYSE AVENUE","Bronx","2010756","10460","203","60","0","60","4","15"
"1485 BRYANT AVENUE","Bronx","2010770","10460","203","20","0","20","3","6.7"
"1481 BRYANT AVENUE","Bronx","2010771","10460","203","10","0","10","3","3.3"
"1459 BRYANT AVENUE","Bronx","2010775","10460","203","13","0","13","3","4.3"
"1442 BRYANT AVENUE","Bronx","2010821","10459","203","16","2","18","3","6"
"1448 BRYANT AVENUE","Bronx","2010823","10459","203","15","11","26","3","8.7"
"1447 LONGFELLOW AVENUE","Bronx","2010828","10459","203","22","0","22","5","4.4"
"1460 BRYANT AVENUE","Bronx","2010842","10460","203","75","0","75","3","25"
"1472 BRYANT AVENUE","Bronx","2010846","10460","203","22","0","22","3","7.3"
"1474 BRYANT AVENUE","Bronx","2010847","10460","203","77","10","87","3","29"
"1494 BRYANT AVENUE","Bronx","2010854","10460","203","30","1","31","3","10.3"
"1552 BRYANT AVENUE","Bronx","2010880","10460","203","24","3","27","3","9"
"1002 EAST TREMONT AVENUE","Bronx","2010894","10460","206","139","1","140","31","4.5"
"2486 TIEBOUT AVENUE","Bronx","2011002","10458","205","46","0","46","8","5.8"
"311 EAST 188 STREET","Bronx","2011050","10458","205","38","5","43","11","3.9"
"361 EAST 188 STREET","Bronx","2011065","10458","205","91","0","91","26","3.5"
"375 EAST 188 STREET","Bronx","2011078","10458","205","222","1","223","47","4.7"
"2272 WEBSTER AVENUE","Bronx","2011171","10457","206","18","0","18","6","3"
"2338 WEBSTER AVENUE","Bronx","2011185","10458","206","29","3","32","8","4"
"2378 WEBSTER AVENUE","Bronx","2011196","10458","206","25","0","25","8","3.1"
"2382 WEBSTER AVENUE","Bronx","2011198","10458","206","25","2","27","8","3.4"
"400 EAST 187 STREET","Bronx","2011200","10458","206","72","0","72","18","4"
"2406 WEBSTER AVENUE","Bronx","2011215","10458","206","125","0","125","8","15.6"
"2408 WEBSTER AVENUE","Bronx","2011216","10458","206","115","1","116","8","14.5"
"2416 WEBSTER AVENUE","Bronx","2011218","10458","206","67","0","67","8","8.4"
"2420 WEBSTER AVENUE","Bronx","2011219","10458","206","119","3","122","8","15.3"
"2422 WEBSTER AVENUE","Bronx","2011220","10458","206","36","0","36","8","4.5"
"4354 PARK AVENUE","Bronx","2011275","10457","206","11","0","11","3","3.7"
"2037 WASHINGTON AVENUE","Bronx","2011287","10457","206","7","13","20","3","6.7"
"2179 WASHINGTON AVENUE","Bronx","2011324","10457","206","331","0","331","34","9.7"
"2357 WASHINGTON AVENUE","Bronx","2011381","10458","206","39","1","40","12","3.3"
"459 EAST 185 STREET","Bronx","2011388","10458","206","9","0","9","3","3"
"444 EAST 187 STREET","Bronx","2011392","10458","206","93","0","93","28","3.3"
"441 EAST 187 STREET","Bronx","2011404","10458","206","166","1","167","18","9.3"
"457 EAST 187 STREET","Bronx","2011415","10458","206","103","2","105","47","2.2"
"490 EAST 181 STREET","Bronx","2011503","10457","206","96","0","96","24","4"
"2158 BATHGATE AVENUE","Bronx","2011511","10457","206","14","0","14","3","4.7"
"546 EAST 182 STREET","Bronx","2011528","10457","206","93","1","94","25","3.8"
"2235 BASSFORD AVENUE","Bronx","2011545","10457","206","146","0","146","32","4.6"
"2260 WASHINGTON AVENUE","Bronx","2011546","10457","206","111","1","112","20","5.6"
"4533 3 AVENUE","Bronx","2011602","10458","206","30","1","31","8","3.9"
"490 EAST 184 STREET","Bronx","2011629","10458","206","85","0","85","16","5.3"
"2330 WASHINGTON AVENUE","Bronx","2011630","10458","206","63","0","63","20","3.1"
"2334 WASHINGTON AVENUE","Bronx","2011631","10458","206","111","0","111","31","3.6"
"2344 LORILLARD PLACE","Bronx","2011649","10458","206","101","0","101","3","33.7"
"510 EAST  188 STREET","Bronx","2011756","10458","206","15","0","15","3","5"
"523 EAST 187 STREET","Bronx","2011767","10458","206","18","0","18","3","6"
"519 EAST 187 STREET","Bronx","2011769","10458","206","7","4","11","3","3.7"
"550 EAST 189 STREET","Bronx","2011792","10458","206","54","1","55","17","3.2"
"2500 BATHGATE AVENUE","Bronx","2011819","10458","206","25","0","25","6","4.2"
"553 EAST 180 STREET","Bronx","2011853","10457","206","97","0","97","24","4"
"2509 HOFFMAN STREET","Bronx","2011939","10458","206","103","1","104","25","4.2"
"601 EAST 178 STREET","Bronx","2011977","10457","206","67","0","67","21","3.2"
"620 EAST 178 STREET","Bronx","2011989","10457","206","508","1","509","47","10.8"
"2070 ARTHUR AVENUE","Bronx","2012006","10457","206","279","0","279","27","10.3"
"2074 ARTHUR AVENUE","Bronx","2012007","10457","206","121","0","121","27","4.5"
"2025 HUGHES AVENUE","Bronx","2012021","10457","206","13","11","24","3","8"
"2019 HUGHES AVENUE","Bronx","2012023","10457","206","93","0","93","8","11.6"
"624 EAST 183 STREET","Bronx","2012092","10458","206","44","0","44","6","7.3"
"2303 HUGHES AVENUE","Bronx","2012114","10458","206","12","0","12","3","4"
"2371 HUGHES AVENUE","Bronx","2012145","10458","206","37","1","38","9","4.2"
"2334 HUGHES AVENUE","Bronx","2012150","10458","206","93","5","98","16","6.1"
"633 EAST 186 STREET","Bronx","2012168","10458","206","99","0","99","29","3.4"
"1980 BELMONT AVENUE","Bronx","2012297","10457","206","18","0","18","3","6"
"1986 BELMONT AVENUE","Bronx","2012300","10457","206","118","0","118","3","39.3"
"676 EAST 179 STREET","Bronx","2012308","10457","206","46","0","46","8","5.8"
"1978 BELMONT AVENUE","Bronx","2012314","10457","206","2","18","20","3","6.7"
"2082 HUGHES AVENUE","Bronx","2012316","10457","206","100","1","101","28","3.6"
"672 EAST 180 STREET","Bronx","2012342","10457","206","15","10","25","3","8.3"
"2113 BELMONT AVENUE","Bronx","2012357","10457","206","54","0","54","9","6"
"2153 BELMONT AVENUE","Bronx","2012389","10457","206","36","0","36","3","12"
"2303 BELMONT AVENUE","Bronx","2012462","10458","206","35","0","35","9","3.9"
"2309 BEAUMONT AVENUE","Bronx","2012528","10458","206","12","0","12","3","4"
"690 EAST 189 STREET","Bronx","2012554","10458","206","124","0","124","36","3.4"
"2472 CAMBRELENG AVENUE","Bronx","2012589","10458","206","29","0","29","5","5.8"
"2476 CAMBRELENG AVENUE","Bronx","2012591","10458","206","89","0","89","17","5.2"
"701 EAST 189 STREET","Bronx","2012605","10458","206","36","0","36","6","6"
"731 EAST 178 STREET","Bronx","2012633","10457","206","29","0","29","3","9.7"
"2006 CROTONA AVENUE","Bronx","2012656","10457","206","8","1","9","3","3"
"2068 CROTONA AVENUE","Bronx","2012667","10457","206","10","0","10","3","3.3"
"2104 CROTONA AVENUE","Bronx","2012692","10457","206","10","0","10","3","3.3"
"2120 CROTONA AVENUE","Bronx","2012696","10457","206","191","9","200","36","5.6"
"716 EAST  181 STREET","Bronx","2012697","10457","206","10","0","10","3","3.3"
"2117 CLINTON AVENUE","Bronx","2012703","10457","206","35","0","35","3","11.7"
"2162 CROTONA AVENUE","Bronx","2012764","10457","206","22","0","22","3","7.3"
"2164 CROTONA AVENUE","Bronx","2012765","10457","206","50","0","50","3","16.7"
"2166 CROTONA AVENUE","Bronx","2012766","10457","206","18","3","21","3","7"
"790 GROTE STREET","Bronx","2012797","10460","206","29","0","29","4","7.3"
"2284 BEAUMONT AVENUE","Bronx","2012808","10457","206","42","0","42","4","10.5"
"2308 CROTONA AVENUE","Bronx","2012824","10458","206","133","7","140","22","6.4"
"2364 CROTONA AVENUE","Bronx","2012835","10458","206","21","0","21","3","7"
"2307 PROSPECT AVENUE","Bronx","2012850","10458","206","16","0","16","4","4"
"2312 BEAUMONT AVENUE","Bronx","2012864","10458","206","61","0","61","6","10.2"
"2327 CROTONA AVENUE","Bronx","2012877","10458","206","33","0","33","9","3.7"
"2323 CROTONA AVENUE","Bronx","2012878","10458","206","67","1","68","9","7.6"
"2429 PROSPECT AVENUE","Bronx","2012889","10458","206","52","0","52","8","6.5"
"2427 PROSPECT AVENUE","Bronx","2012890","10458","206","19","0","19","3","6.3"
"737 EAST 187 STREET","Bronx","2012898","10458","206","95","0","95","31","3.1"
"2470 BEAUMONT AVENUE","Bronx","2012912","10458","206","105","2","107","12","8.9"
"2425 CROTONA AVENUE","Bronx","2012920","10458","206","105","25","130","5","26"
"2411 CROTONA AVENUE","Bronx","2012926","10458","206","24","0","24","4","6"
"2409 CROTONA AVENUE","Bronx","2012927","10458","206","37","0","37","9","4.1"
"2000 PROSPECT AVENUE","Bronx","2012931","10457","206","553","0","553","66","8.4"
"2009 MAPES AVENUE","Bronx","2012933","10460","206","35","0","35","6","5.8"
"817 EAST 178 STREET","Bronx","2012949","10460","206","164","0","164","36","4.6"
"1967 MARMION AVENUE","Bronx","2012951","10460","206","177","1","178","73","2.4"
"2048 MAPES AVENUE","Bronx","2012953","10460","206","144","0","144","13","11.1"
"2052 MAPES AVENUE","Bronx","2012954","10460","206","80","2","82","13","6.3"
"783 GROTE STREET","Bronx","2013022","10460","206","63","1","64","12","5.3"
"2348 PROSPECT AVENUE","Bronx","2013043","10458","206","21","0","21","3","7"
"771 EAST 185 STREET","Bronx","2013056","10460","206","90","0","90","21","4.3"
"2420 PROSPECT AVENUE","Bronx","2013062","10458","206","102","4","106","52","2"
"2440 PROSPECT AVENUE","Bronx","2013064","10458","206","134","24","158","3","52.7"
"2116 CROTONA PARKWAY","Bronx","2013099","10460","206","223","0","223","23","9.7"
"2150 CROTONA PARKWAY","Bronx","2013106","10460","206","40","0","40","11","3.6"
"910 EAST 178 STREET","Bronx","2013114","10460","206","25","0","25","8","3.1"
"1997 DALY AVENUE","Bronx","2013129","10460","206","27","0","27","9","3"
"2095 HONEYWELL AVENUE","Bronx","2013150","10460","206","90","3","93","28","3.3"
"2147 HONEYWELL AVENUE","Bronx","2013169","10460","206","187","0","187","31","6"
"2112 HONEYWELL AVENUE","Bronx","2013177","10460","206","157","1","158","11","14.4"
"900 BRONX PARK SOUTH","Bronx","2013184","10460","206","140","0","140","43","3.3"
"943 EAST 179 STREET","Bronx","2013208","10460","206","30","0","30","9","3.3"
"2067 VYSE AVENUE","Bronx","2013227","10460","206","50","0","50","9","5.6"
"2114 DALY AVENUE","Bronx","2013229","10460","206","164","2","166","28","5.9"
"2115 VYSE AVENUE","Bronx","2013232","10460","206","161","1","162","20","8.1"
"2070 VYSE AVENUE","Bronx","2013252","10460","206","35","0","35","9","3.9"
"2086 VYSE AVENUE","Bronx","2013256","10460","206","45","0","45","9","5"
"980 BRONX PARK SOUTH","Bronx","2013273","10460","206","14","0","14","4","3.5"
"990 BRONX PARK SOUTH","Bronx","2013275","10460","206","168","0","168","53","3.2"
"2051 WEBSTER AVENUE","Bronx","2013298","10457","205","96","2","98","29","3.4"
"2101 WEBSTER AVENUE","Bronx","2013309","10457","205","12","0","12","4","3"
"2099 WEBSTER AVENUE","Bronx","2013310","10457","205","31","0","31","8","3.9"
"2160 TIEBOUT AVENUE","Bronx","2013317","10457","205","125","4","129","60","2.1"
"363 EAST 180 STREET","Bronx","2013318","10457","205","37","0","37","9","4.1"
"386 EAST 184 STREET","Bronx","2013330","10458","205","71","0","71","3","23.7"
"384 EAST 184 STREET","Bronx","2013331","10458","205","22","0","22","4","5.5"
"2302 VALENTINE AVENUE","Bronx","2013427","10458","205","83","1","84","27","3.1"
"2335 TIEBOUT AVENUE","Bronx","2013441","10458","205","8","3","11","3","3.7"
"2386 VALENTINE AVENUE","Bronx","2013449","10458","205","10","0","10","3","3.3"
"2092 RYER AVENUE","Bronx","2013530","10457","205","23","2","25","3","8.3"
"2098 RYER AVENUE","Bronx","2013532","10457","205","81","0","81","3","27"
"2145 VALENTINE AVENUE","Bronx","2013550","10457","205","285","0","285","25","11.4"
"265 EAST 182 STREET","Bronx","2013563","10457","205","76","0","76","25","3"
"2342 RYER AVENUE","Bronx","2013567","10458","205","202","1","203","31","6.5"
"2343 VALENTINE AVENUE","Bronx","2013574","10458","205","332","0","332","30","11.1"
"261 EAST 184 STREET","Bronx","2013582","10458","205","149","7","156","28","5.6"
"2537 VALENTINE AVENUE","Bronx","2013612","10458","207","109","0","109","52","2.1"
"2060 GRAND CONCOURSE","Bronx","2013629","10457","205","128","0","128","40","3.2"
"217 EAST BURNSIDE AVENUE","Bronx","2013642","10457","205","31","0","31","3","10.3"
"2105 RYER AVENUE","Bronx","2013695","10457","205","380","1","381","53","7.2"
"2183 RYER AVENUE","Bronx","2013714","10457","205","11","0","11","3","3.7"
"2250 GRAND CONCOURSE","Bronx","2013721","10457","205","180","12","192","22","8.7"
"2254 GRAND CONCOURSE","Bronx","2013722","10457","205","37","6","43","10","4.3"
"2270 GRAND CONCOURSE","Bronx","2013724","10457","205","99","0","99","41","2.4"
"2084 CRESTON AVENUE","Bronx","2013745","10453","205","112","0","112","52","2.2"
"2320 CRESTON AVENUE","Bronx","2013776","10468","205","99","3","102","43","2.4"
"2390 CRESTON AVENUE","Bronx","2013792","10468","205","68","0","68","20","3.4"
"2546 CRESTON AVENUE","Bronx","2013817","10468","207","45","0","45","11","4.1"
"2565 GRAND CONCOURSE","Bronx","2013820","10468","207","94","3","97","43","2.3"
"2324 MORRIS AVENUE","Bronx","2013885","10468","205","124","0","124","42","3"
"108 FIELD PLACE","Bronx","2013886","10468","205","149","4","153","60","2.5"
"2403 CRESTON AVENUE","Bronx","2013915","10468","205","96","0","96","31","3.1"
"2 EAST 181 STREET","Bronx","2013962","10453","205","125","1","126","31","4.1"
"2160 WALTON AVENUE","Bronx","2013969","10453","205","447","0","447","48","9.3"
"2255 MORRIS AVENUE","Bronx","2013998","10453","205","109","9","118","43","2.7"
"2485 MORRIS AVENUE","Bronx","2014127","10468","207","114","1","115","37","3.1"
"2084 GRAND AVENUE","Bronx","2014161","10453","205","99","2","101","48","2.1"
"2109 DAVIDSON AVENUE","Bronx","2014174","10453","205","0","10","10","3","3.3"
"2107 DAVIDSON AVENUE","Bronx","2014175","10453","205","0","14","14","3","4.7"
"2200 GRAND AVENUE","Bronx","2014203","10453","205","114","5","119","49","2.4"
"2205 DAVIDSON AVENUE","Bronx","2014205","10453","205","678","19","697","49","14.2"
"2290 DAVIDSON AVENUE","Bronx","2014233","10468","207","367","7","374","55","6.8"
"2344 DAVIDSON AVENUE","Bronx","2014265","10468","207","441","17","458","60","7.6"
"2349 JEROME AVENUE","Bronx","2014282","10468","207","30","1","31","3","10.3"
"2347 JEROME AVENUE","Bronx","2014283","10468","207","45","1","46","3","15.3"
"2366 DAVIDSON AVENUE","Bronx","2014289","10468","207","9","0","9","3","3"
"2415 DAVIDSON AVENUE","Bronx","2014311","10468","207","86","0","86","37","2.3"
"2439 JEROME AVENUE","Bronx","2014330","10468","207","32","0","32","6","5.3"
"2490 DAVIDSON AVENUE","Bronx","2014358","10468","207","153","3","156","36","4.3"
"20 WEST 190 STREET","Bronx","2014359","10468","207","270","4","274","37","7.4"
"2615 JEROME AVENUE","Bronx","2014402","10468","207","133","0","133","26","5.1"
"2473 DAVIDSON AVENUE","Bronx","2014422","10468","207","163","2","165","22","7.5"
"74 CLINTON PLACE","Bronx","2014484","10453","205","15","0","15","3","5"
"61 WEST 181 STREET","Bronx","2014497","10453","205","66","0","66","4","16.5"
"2055 HARRISON AVENUE","Bronx","2014570","10453","205","156","3","159","70","2.3"
"2328 UNIVERSITY AVENUE","Bronx","2014603","10468","207","299","1","300","11","27.3"
"2348 UNIVERSITY AVENUE","Bronx","2014609","10468","207","32","1","33","9","3.7"
"2352 UNIVERSITY AVENUE","Bronx","2014610","10468","207","275","1","276","9","30.7"
"55 WEST 184 STREET","Bronx","2014618","10468","207","95","0","95","27","3.5"
"2455 GRAND AVENUE","Bronx","2014636","10468","207","133","0","133","36","3.7"
"2477 AQUEDUCT AVENUE","Bronx","2014641","10468","207","16","0","16","4","4"
"2497 GRAND AVENUE","Bronx","2014645","10468","207","198","2","200","37","5.4"
"2487 GRAND AVENUE","Bronx","2014646","10468","207","159","1","160","42","3.8"
"2529B GRAND AVENUE","Bronx","2014659","10468","207","14","0","14","3","4.7"
"2541 AQUEDUCT AVENUE","Bronx","2014667","10468","207","132","0","132","37","3.6"
"95 WEST 183 STREET","Bronx","2014732","10453","207","102","0","102","21","4.9"
"2296 ANDREWS AVENUE","Bronx","2014739","10468","207","202","0","202","28","7.2"
"2291 UNIVERSITY AVENUE","Bronx","2014747","10468","207","46","5","51","15","3.4"
"2492 DEVOE TERRACE","Bronx","2014803","10468","207","126","0","126","50","2.5"
"2500 WEBB AVENUE","Bronx","2014837","10468","207","164","0","164","58","2.8"
"2515 UNIVERSITY AVENUE","Bronx","2014847","10468","207","156","20","176","65","2.7"
"2505 UNIVERSITY AVENUE","Bronx","2014848","10468","207","75","1","76","36","2.1"
"1920 LORING PLACE","Bronx","2014854","10453","205","52","0","52","11","4.7"
"128 WEST 183 STREET","Bronx","2014901","10453","207","114","0","114","51","2.2"
"102 WEST 183 STREET","Bronx","2014909","10453","207","103","0","103","43","2.4"
"2277 ANDREWS AVENUE","Bronx","2014921","10468","207","101","2","103","49","2.1"
"1932 HENNESSY PLACE","Bronx","2015029","10453","205","40","0","40","5","8"
"1915 LORING PLACE","Bronx","2015045","10453","205","8","1","9","3","3"
"208 WEST FORDHAM ROAD","Bronx","2015106","10468","207","58","4","62","15","4.1"
"160 WEST KINGSBRIDGE ROAD","Bronx","2015138","10463","207","181","4","185","37","5"
"2763 RESERVOIR AVENUE","Bronx","2015309","10468","208","15","0","15","3","5"
"2755 RESERVOIR AVENUE","Bronx","2015310","10468","208","175","2","177","64","2.8"
"125 WEST 195 STREET","Bronx","2015344","10468","208","134","6","140","37","3.8"
"2776 SEDGWICK AVENUE","Bronx","2015373","10468","208","3","25","28","4","7"
"2848 SEDGWICK AVENUE","Bronx","2015398","10468","208","12","0","12","4","3"
"2849 WEBB AVENUE","Bronx","2015401","10468","208","85","0","85","28","3"
"2856 WEBB AVENUE","Bronx","2015418","10468","208","294","27","321","25","12.8"
"2701 SEDGWICK AVENUE","Bronx","2015500","10468","208","149","0","149","69","2.2"
"2750 KINGSBRIDGE TERRACE","Bronx","2015513","10463","208","68","1","69","9","7.7"
"2789 KINGSBRIDGE TERRACE","Bronx","2015699","10463","208","68","0","68","4","17"
"2865 KINGSBRIDGE TERRACE","Bronx","2015735","10463","208","218","3","221","104","2.1"
"3030 HEATH AVENUE","Bronx","2015749","10463","208","123","1","124","27","4.6"
"3138 BAILEY AVENUE","Bronx","2015929","10463","208","114","0","114","47","2.4"
"3071 HEATH AVENUE","Bronx","2015936","10463","208","114","2","116","43","2.7"
"3306 BAILEY AVENUE","Bronx","2015949","10463","208","83","0","83","10","8.3"
"3840 ORLOFF AVENUE","Bronx","2016064","10463","208","186","12","198","57","3.5"
"160 WEST 231 STREET","Bronx","2016133","10463","208","86","0","86","19","4.5"
"226 WEST 238 STREET","Bronx","2016178","10463","208","90","0","90","29","3.1"
"3816 REVIEW PLACE","Bronx","2016213","10463","208","205","22","227","59","3.8"
"2535 DECATUR AVENUE","Bronx","2016326","10458","207","96","7","103","27","3.8"
"357 EAST 193 STREET","Bronx","2016343","10458","207","104","0","104","11","9.5"
"2656 DECATUR AVENUE","Bronx","2016364","10458","207","73","0","73","23","3.2"
"2676 DECATUR AVENUE","Bronx","2016367","10458","207","59","0","59","16","3.7"
"390 EAST  195 STREET","Bronx","2016368","10458","207","25","0","25","3","8.3"
"2720 DECATUR AVENUE","Bronx","2016378","10458","207","311","3","314","26","12.1"
"391 EAST 198 STREET","Bronx","2016405","10458","207","8","4","12","4","3"
"2676 MARION AVENUE","Bronx","2016475","10458","207","18","0","18","5","3.6"
"2700 MARION AVENUE","Bronx","2016494","10458","207","129","3","132","60","2.2"
"2711 DECATUR AVENUE","Bronx","2016505","10458","207","33","10","43","3","14.3"
"2707 DECATUR AVENUE","Bronx","2016507","10458","207","13","1","14","3","4.7"
"2572 BAINBRIDGE AVENUE","Bronx","2016592","10458","207","15","1","16","3","5.3"
"2576 BAINBRIDGE AVENUE","Bronx","2016594","10458","207","15","0","15","3","5"
"2732 BAINBRIDGE AVENUE","Bronx","2016627","10458","207","162","0","162","66","2.5"
"2677 MARION AVENUE","Bronx","2016639","10458","207","37","0","37","3","12.3"
"2795 MARION AVENUE","Bronx","2016685","10458","207","53","0","53","3","17.7"
"2775 POND PLACE","Bronx","2016729","10458","207","13","1","14","3","4.7"
"2969 PERRY AVENUE","Bronx","2016771","10458","207","12","0","12","3","4"
"253 EAST KINGSBRIDGE ROAD","Bronx","2016820","10458","207","34","0","34","11","3.1"
"2674 BRIGGS AVENUE","Bronx","2016844","10458","207","0","43","43","3","14.3"
"2690 VALENTINE AVENUE","Bronx","2017001","10458","207","34","0","34","10","3.4"
"2776 VALENTINE AVENUE","Bronx","2017034","10458","207","23","0","23","6","3.8"
"2872 VALENTINE AVENUE","Bronx","2017080","10458","207","14","0","14","3","4.7"
"2882 VALENTINE AVENUE","Bronx","2017083","10458","207","21","0","21","3","7"
"243 BEDFORD PARK BOULEVARD","Bronx","2017131","10458","207","32","1","33","6","5.5"
"2754 GRAND CONCOURSE","Bronx","2017141","10458","207","190","1","191","67","2.9"
"215 EAST 197 STREET","Bronx","2017155","10458","207","173","1","174","52","3.3"
"220 EAST 197 STREET","Bronx","2017158","10458","207","158","4","162","65","2.5"
"2909 VALENTINE AVENUE","Bronx","2017179","10458","207","175","1","176","36","4.9"
"234 EAST 204 STREET","Bronx","2017269","10458","207","32","1","33","6","5.5"
"17 EAST 204 STREET","Bronx","2017322","10468","207","19","0","19","6","3.2"
"3128 VILLA AVENUE","Bronx","2017324","10468","207","90","0","90","27","3.3"
"3176 VILLA AVENUE","Bronx","2017333","10468","207","23","0","23","7","3.3"
"172 EAST  205 STREET","Bronx","2017350","10458","207","30","0","30","3","10"
"174 EAST 206 STREET","Bronx","2017372","10458","207","52","0","52","9","5.8"
"176 EAST 206 STREET","Bronx","2017373","10458","207","16","0","16","3","5.3"
"203 EAST 205 STREET","Bronx","2017382","10458","207","23","2","25","3","8.3"
"179 EAST  205 STREET","Bronx","2017390","10458","207","21","0","21","7","3"
"112 EAST 198 STREET","Bronx","2017460","10468","207","4","5","9","3","3"
"2710 MORRIS AVENUE","Bronx","2017476","10468","207","359","9","368","61","6"
"2705 MORRIS AVENUE","Bronx","2017492","10468","207","143","2","145","27","5.4"
"222 BEDFORD PARK BOULEVARD","Bronx","2017621","10458","207","137","0","137","63","2.2"
"3071 VILLA AVENUE","Bronx","2017639","10468","207","2","13","15","3","5"
"3122 JEROME AVENUE","Bronx","2017644","10468","207","13","0","13","3","4.3"
"3433 GATES PLACE","Bronx","2017675","10467","207","133","2","135","50","2.7"
"25 EAST MOSHOLU PARKWAY NORTH","Bronx","2017753","10467","207","127","2","129","53","2.4"
"3551 DEKALB AVENUE","Bronx","2017797","10467","207","221","9","230","77","3"
"3572 DEKALB AVENUE","Bronx","2017835","10467","207","167","3","170","70","2.4"
"3569 DEKALB AVENUE","Bronx","2017838","10467","207","344","1","345","54","6.4"
"3066 WEBSTER AVENUE","Bronx","2017870","10467","207","25","0","25","3","8.3"
"3044 DECATUR AVENUE","Bronx","2017880","10467","207","18","0","18","3","6"
"3080 DECATUR AVENUE","Bronx","2017885","10467","207","1","12","13","3","4.3"
"3100 DECATUR AVENUE","Bronx","2017891","10467","207","27","0","27","8","3.4"
"353 EAST MOSHOLU PARKWAY NORT","Bronx","2017910","10467","207","94","1","95","26","3.7"
"3038 HULL AVENUE","Bronx","2017911","10467","207","76","0","76","21","3.6"
"359 EAST MOSHOLU PARKWAY NORT","Bronx","2017935","10467","207","63","4","67","21","3.2"
"280 EAST 204 STREET","Bronx","2017972","10467","207","33","0","33","6","5.5"
"3047 PERRY AVENUE","Bronx","2017981","10467","207","40","0","40","3","13.3"
"201 EAST MOSHOLU PARKWAY NORTH","Bronx","2017983","10467","207","71","2","73","21","3.5"
"282 EAST 205 STREET","Bronx","2018102","10467","207","15","3","18","6","3"
"239 EAST  207 STREET","Bronx","2018175","10467","207","36","0","36","11","3.3"
"281 RESERVOIR PLACE","Bronx","2018217","10467","207","11","0","11","3","3.7"
"167 EAST GUN HILL ROAD","Bronx","2018254","10467","207","116","0","116","51","2.3"
"3534 TRYON AVENUE","Bronx","2018285","10467","207","16","0","16","4","4"
"3324 PERRY AVENUE","Bronx","2018381","10467","207","27","0","27","4","6.8"
"345 EAST 209 STREET","Bronx","2018523","10467","207","84","1","85","26","3.3"
"364 EAST 209 STREET","Bronx","2018584","10467","207","79","0","79","26","3"
"3342 DECATUR AVENUE","Bronx","2018607","10467","207","26","0","26","3","8.7"
"323 EAST GUN HILL ROAD","Bronx","2018642","10467","207","119","4","123","53","2.3"
"67 EAST  236 STREET","Bronx","2018855","10470","212","41","0","41","7","5.9"
"255 EAST 237 STREET","Bronx","2019213","10470","212","35","0","35","9","3.9"
"170 SOUNDVIEW AVENUE","Bronx","2019992","10473","209","31","0","31","6","5.2"
"259 UNDERHILL AVENUE","Bronx","2020133","10473","209","18","0","18","4","4.5"
"1888 LACOMBE AVENUE","Bronx","2020905","10473","209","15","0","15","4","3.8"
"1825 LACOMBE AVENUE","Bronx","2021448","10473","209","53","0","53","5","10.6"
"553 SOUNDVIEW AVENUE","Bronx","2021462","10473","209","17","0","17","3","5.7"
"505 SOUNDVIEW AVENUE","Bronx","2021479","10473","209","24","0","24","4","6"
"529 UNDERHILL AVENUE","Bronx","2021522","10473","209","43","2","45","4","11.3"
"652 ROSEDALE AVENUE","Bronx","2021701","10473","209","14","0","14","3","4.7"
"1756 SEWARD AVENUE","Bronx","2021710","10473","209","20","6","26","3","8.7"
"636 COMMONWEALTH AVENUE","Bronx","2021745","10473","209","11","0","11","3","3.7"
"652 SOUNDVIEW AVENUE","Bronx","2021837","10473","209","51","2","53","7","7.6"
"630 TAYLOR AVENUE","Bronx","2021854","10473","209","67","0","67","3","22.3"
"737 NOBLE AVENUE","Bronx","2021979","10473","209","9","0","9","3","3"
"737 COMMONWEALTH AVENUE","Bronx","2022061","10473","209","20","0","20","3","6.7"
"1773 SEWARD AVENUE","Bronx","2022082","10473","209","0","58","58","3","19.3"
"2000 HOMER AVENUE","Bronx","2022208","10473","209","430","3","433","154","2.8"
"2109 VIRGIL PLACE","Bronx","2022380","10473","209","19","0","19","3","6.3"
"1050 WHEELER AVENUE","Bronx","2023431","10472","209","166","1","167","59","2.8"
"1041 ELDER AVENUE","Bronx","2023435","10472","209","68","0","68","5","13.6"
"1037 ELDER AVENUE","Bronx","2023437","10472","209","103","0","103","5","20.6"
"1015 BOYNTON AVENUE","Bronx","2023445","10472","209","148","5","153","70","2.2"
"1024 ELDER AVENUE","Bronx","2023458","10472","209","111","0","111","5","22.2"
"1025 BOYNTON AVENUE","Bronx","2023480","10472","209","124","2","126","61","2.1"
"1020 BOYNTON AVENUE","Bronx","2023482","10472","209","125","13","138","67","2.1"
"1019 WARD AVENUE","Bronx","2023510","10472","209","45","0","45","3","15"
"1040 WARD AVENUE","Bronx","2023522","10472","209","9","0","9","3","3"
"1064 WARD AVENUE","Bronx","2023532","10472","209","162","0","162","55","2.9"
"1055 MANOR AVENUE","Bronx","2023536","10472","209","17","0","17","4","4.3"
"1051 MANOR AVENUE","Bronx","2023538","10472","209","19","0","19","4","4.8"
"1039 MANOR AVENUE","Bronx","2023544","10472","209","13","0","13","4","3.3"
"1035 MANOR AVENUE","Bronx","2023546","10472","209","105","6","111","4","27.8"
"1023 MANOR AVENUE","Bronx","2023552","10472","209","16","0","16","4","4"
"1038 WHITE PLAINS ROAD","Bronx","2023665","10472","209","72","0","72","6","12"
"1173 COLGATE AVENUE","Bronx","2023723","10472","209","38","0","38","4","9.5"
"1121 COLGATE AVENUE","Bronx","2023747","10472","209","21","0","21","4","5.3"
"1165 EVERGREEN AVENUE","Bronx","2023765","10472","209","110","0","110","40","2.8"
"1155 EVERGREEN AVENUE","Bronx","2023766","10472","209","94","0","94","40","2.4"
"1163 WHEELER AVENUE","Bronx","2023780","10472","209","14","0","14","4","3.5"
"1159 WHEELER AVENUE","Bronx","2023782","10472","209","12","0","12","4","3"
"1137 WHEELER AVENUE","Bronx","2023792","10472","209","22","0","22","4","5.5"
"1133 WHEELER AVENUE","Bronx","2023794","10472","209","13","0","13","4","3.3"
"1144 WHEELER AVENUE","Bronx","2023822","10472","209","12","0","12","4","3"
"1158 WHEELER AVENUE","Bronx","2023829","10472","209","17","0","17","4","4.3"
"1161 ELDER AVENUE","Bronx","2023835","10472","209","118","4","122","49","2.5"
"1117 BOYNTON AVENUE","Bronx","2023877","10472","209","19","0","19","4","4.8"
"1115 BOYNTON AVENUE","Bronx","2023878","10472","209","14","0","14","4","3.5"
"1109 BOYNTON AVENUE","Bronx","2023881","10472","209","37","0","37","4","9.3"
"1118 BOYNTON AVENUE","Bronx","2023885","10472","209","51","1","52","4","13"
"1136 BOYNTON AVENUE","Bronx","2023894","10472","209","35","0","35","4","8.8"
"1158 BOYNTON AVENUE","Bronx","2023896","10472","209","162","10","172","66","2.6"
"1147 MANOR AVENUE","Bronx","2023949","10472","209","15","0","15","4","3.8"
"1143 MANOR AVENUE","Bronx","2023951","10472","209","22","0","22","4","5.5"
"1123 MANOR AVENUE","Bronx","2023961","10472","209","40","0","40","4","10"
"1124 STRATFORD AVENUE","Bronx","2024019","10472","209","95","0","95","40","2.4"
"1134 STRATFORD AVENUE","Bronx","2024020","10472","209","136","0","136","40","3.4"
"1127 FTELEY AVENUE","Bronx","2024051","10472","209","49","0","49","4","12.3"
"1123 FTELEY AVENUE","Bronx","2024052","10472","209","13","0","13","4","3.3"
"1121 FTELEY AVENUE","Bronx","2024053","10472","209","28","0","28","4","7"
"1120 METCALF AVENUE","Bronx","2024067","10472","209","25","0","25","4","6.3"
"1117 CROES AVENUE","Bronx","2024108","10472","209","14","0","14","4","3.5"
"1142 FTELEY AVENUE","Bronx","2024137","10472","209","16","0","16","4","4"
"1150 FTELEY AVENUE","Bronx","2024141","10472","209","11","4","15","4","3.8"
"1119 NOBLE AVENUE","Bronx","2024167","10472","209","25","0","25","4","6.3"
"1129 ST LAWRENCE AVENUE","Bronx","2024237","10472","209","96","0","96","25","3.8"
"1162 ST LAWRENCE AVENUE","Bronx","2024266","10472","209","38","0","38","8","4.8"
"1147 WHITE PLAINS ROAD","Bronx","2024500","10472","209","14","0","14","4","3.5"
"1144 WHITE PLAINS ROAD","Bronx","2024539","10472","209","72","0","72","4","18"
"1115 VIRGINIA AVENUE","Bronx","2024561","10472","209","149","3","152","5","30.4"
"1226 ROSEDALE AVENUE","Bronx","2024613","10472","209","15","0","15","5","3"
"1212 COMMONWEALTH AVENUE","Bronx","2024640","10472","209","17","0","17","4","4.3"
"1220 COMMONWEALTH AVENUE","Bronx","2024644","10472","209","24","0","24","4","6"
"1227 ST LAWRENCE AVENUE","Bronx","2024660","10472","209","21","0","21","3","7"
"1237 BEACH AVENUE","Bronx","2024702","10472","209","47","7","54","5","10.8"
"1813 GLEASON AVENUE","Bronx","2024713","10472","209","31","0","31","3","10.3"
"1210 BEACH AVENUE","Bronx","2024719","10472","209","43","0","43","3","14.3"
"1838 WESTCHESTER AVENUE","Bronx","2024785","10472","209","124","1","125","4","31.3"
"1849 GLEASON AVENUE","Bronx","2024810","10472","209","32","0","32","5","6.4"
"1230 LELAND AVENUE","Bronx","2024862","10472","209","112","0","112","49","2.3"
"1250 LELAND AVENUE","Bronx","2024867","10472","209","119","0","119","43","2.8"
"1901 GLEASON AVENUE","Bronx","2024880","10472","209","86","1","87","29","3"
"1245 BRONX RIVER AVENUE","Bronx","2024956","10472","209","45","2","47","4","11.8"
"1226 EVERGREEN AVENUE","Bronx","2025050","10472","209","38","1","39","11","3.5"
"1238 EVERGREEN AVENUE","Bronx","2025056","10472","209","23","2","25","4","6.3"
"1233 WHEELER AVENUE","Bronx","2025095","10472","209","10","0","10","3","3.3"
"1211 WHEELER AVENUE","Bronx","2025102","10472","209","40","0","40","11","3.6"
"1233 ELDER AVENUE","Bronx","2025148","10472","209","19","0","19","3","6.3"
"1209 ELDER AVENUE","Bronx","2025154","10472","209","90","0","90","11","8.2"
"1533 WESTCHESTER AVENUE","Bronx","2025161","10472","209","73","1","74","10","7.4"
"1531 WESTCHESTER AVENUE","Bronx","2025162","10472","209","31","0","31","10","3.1"
"1234 ELDER AVENUE","Bronx","2025172","10472","209","17","0","17","4","4.3"
"1244 BOYNTON AVENUE","Bronx","2025237","10472","209","14","0","14","4","3.5"
"1263 WARD AVENUE","Bronx","2025256","10472","209","11","0","11","3","3.7"
"1235 WARD AVENUE","Bronx","2025270","10472","209","14","0","14","3","4.7"
"1254 MANOR AVENUE","Bronx","2025341","10472","209","39","4","43","6","7.2"
"1255 STRATFORD AVENUE","Bronx","2025349","10472","209","157","8","165","70","2.4"
"1245 STRATFORD AVENUE","Bronx","2025350","10472","209","160","2","162","70","2.3"
"1241 HARROD AVENUE","Bronx","2025406","10472","209","12","0","12","3","4"
"1256 FTELEY AVENUE","Bronx","2025446","10472","209","39","0","39","5","7.8"
"1260 FTELEY AVENUE","Bronx","2025448","10472","209","15","0","15","5","3"
"1271 NOBLE AVENUE","Bronx","2025518","10472","209","17","0","17","4","4.3"
"1256 NOBLE AVENUE","Bronx","2025543","10472","209","116","0","116","4","29"
"1258 NOBLE AVENUE","Bronx","2025544","10472","209","0","28","28","4","7"
"1742 EAST 172 STREET","Bronx","2025588","10472","209","223","6","229","91","2.5"
"1969 CHATTERTON AVENUE","Bronx","2025670","10472","209","13","0","13","3","4.3"
"1970 POWELL AVENUE","Bronx","2025744","10472","209","12","0","12","3","4"
"1958 CROSS BRONX EXPRESSWAY","Bronx","2025920","10472","209","20","0","20","3","6.7"
"2124 CHATTERTON AVENUE","Bronx","2026292","10472","209","26","0","26","4","6.5"
"2128 CHATTERTON AVENUE","Bronx","2026294","10472","209","45","0","45","4","11.3"
"2167 BRUCKNER BOULEVARD","Bronx","2026314","10472","209","21","2","23","3","7.7"
"2147 BRUCKNER BOULEVARD","Bronx","2026319","10472","209","94","5","99","4","24.8"
"2133 BRUCKNER BOULEVARD","Bronx","2026326","10472","209","28","0","28","4","7"
"2136 GLEASON AVENUE","Bronx","2026478","10462","209","19","0","19","3","6.3"
"2250 HAVILAND AVENUE","Bronx","2026718","10462","209","83","0","83","15","5.5"
"2256 HAVILAND AVENUE","Bronx","2026721","10462","209","47","0","47","15","3.1"
"1273 HAVEMEYER AVENUE","Bronx","2026942","10462","209","43","0","43","4","10.8"
"2326 GLEASON AVENUE","Bronx","2027023","10462","209","32","0","32","4","8"
"2333 ELLIS AVENUE","Bronx","2027124","10462","209","80","0","80","5","16"
"1361 BRONX RIVER AVENUE","Bronx","2027335","10472","209","15","0","15","3","5"
"1310 WHEELER AVENUE","Bronx","2027369","10472","209","24","1","25","3","8.3"
"1319 ELDER AVENUE","Bronx","2027393","10472","209","159","0","159","3","53"
"1349 STRATFORD AVENUE","Bronx","2027476","10472","209","427","7","434","72","6"
"1609 EAST  172 STREET","Bronx","2027497","10472","209","20","0","20","4","5"
"1605 EAST 172 STREET","Bronx","2027499","10472","209","37","1","38","4","9.5"
"1310 STRATFORD AVENUE","Bronx","2027502","10472","209","9","8","17","4","4.3"
"1314 STRATFORD AVENUE","Bronx","2027504","10472","209","32","0","32","4","8"
"1318 STRATFORD AVENUE","Bronx","2027506","10472","209","28","0","28","4","7"
"1357 HARROD AVENUE","Bronx","2027551","10472","209","9","0","9","3","3"
"1311 HARROD AVENUE","Bronx","2027571","10472","209","40","0","40","5","8"
"1344 CROES AVENUE","Bronx","2027690","10472","209","11","0","11","3","3.7"
"1723 EAST 172 STREET","Bronx","2027730","10472","209","37","1","38","5","7.6"
"1332 NOBLE AVENUE","Bronx","2027741","10472","209","32","0","32","3","10.7"
"1336 NOBLE AVENUE","Bronx","2027742","10472","209","7","3","10","3","3.3"
"1360 NOBLE AVENUE","Bronx","2027752","10472","209","16","0","16","3","5.3"
"1361 ROSEDALE AVENUE","Bronx","2027761","10472","209","37","2","39","6","6.5"
"1359 ROSEDALE AVENUE","Bronx","2027762","10472","209","21","1","22","4","5.5"
"1324 COMMONWEALTH AVENUE","Bronx","2027831","10472","209","0","13","13","3","4.3"
"1302 ST LAWRENCE AVENUE","Bronx","2027866","10472","209","51","0","51","3","17"
"1339 BEACH AVENUE","Bronx","2027896","10472","209","12","0","12","4","3"
"1311 BEACH AVENUE","Bronx","2027903","10472","209","30","3","33","5","6.6"
"1353 TAYLOR AVENUE","Bronx","2027919","10472","209","19","0","19","5","3.8"
"1342 TAYLOR AVENUE","Bronx","2027941","10472","209","31","0","31","4","7.8"
"1350 TAYLOR AVENUE","Bronx","2027944","10472","209","11","0","11","3","3.7"
"1327 LELAND AVENUE","Bronx","2027991","10472","209","13","0","13","3","4.3"
"1408 BRONX RIVER AVENUE","Bronx","2028036","10472","209","18","0","18","4","4.5"
"1431 CROES AVENUE","Bronx","2028087","10472","209","31","5","36","4","9"
"1425 CROES AVENUE","Bronx","2028090","10472","209","23","0","23","4","5.8"
"1744 MERRILL STREET","Bronx","2028154","10460","209","27","0","27","7","3.9"
"1440 ST LAWRENCE AVENUE","Bronx","2028192","10460","209","9","0","9","3","3"
"1443 BEACH AVENUE","Bronx","2028200","10460","209","13","0","13","4","3.3"
"1453 LELAND AVENUE","Bronx","2028270","10460","209","27","0","27","4","6.8"
"1445 LELAND AVENUE","Bronx","2028274","10460","209","9","5","14","4","3.5"
"1421 LELAND AVENUE","Bronx","2028281","10460","209","37","0","37","4","9.3"
"1460 LELAND AVENUE","Bronx","2028308","10460","209","19","2","21","4","5.3"
"1407 WHITE PLAINS ROAD","Bronx","2028342","10462","209","10","0","10","3","3.3"
"1539 ROSEDALE AVENUE","Bronx","2028424","10460","209","12","0","12","3","4"
"1523 ROSEDALE AVENUE","Bronx","2028427","10460","209","24","0","24","3","8"
"1462 ROSEDALE AVENUE","Bronx","2028439","10460","209","26","0","26","3","8.7"
"1495 BEACH AVENUE","Bronx","2028505","10460","209","11","0","11","3","3.7"
"1489 BEACH AVENUE","Bronx","2028507","10460","209","35","0","35","5","7"
"1528 ROSEDALE AVENUE","Bronx","2028526","10460","209","10","0","10","3","3.3"
"1530 ROSEDALE AVENUE","Bronx","2028527","10460","209","19","0","19","3","6.3"
"1522 ST LAWRENCE AVENUE","Bronx","2028592","10460","209","15","7","22","4","5.5"
"1543 LELAND AVENUE","Bronx","2028651","10460","209","34","0","34","3","11.3"
"1501 WHITE PLAINS ROAD","Bronx","2028682","10462","209","42","0","42","9","4.7"
"2224 LYON AVENUE","Bronx","2041402","10462","210","59","0","59","13","4.5"
"2360 ST RAYMOND AVENUE","Bronx","2041687","10462","210","24","0","24","6","4"
"2512 TRATMAN AVENUE","Bronx","2041847","10461","210","342","4","346","62","5.6"
"1628 GLOVER STREET","Bronx","2041999","10462","210","8","1","9","3","3"
"1666 PARKER STREET","Bronx","2042039","10462","210","34","0","34","9","3.8"
"1711 ZEREGA AVENUE","Bronx","2042056","10462","210","64","0","64","4","16"
"2446 LYVERE STREET","Bronx","2042241","10461","210","221","0","221","38","5.8"
"1753 SEDDON STREET","Bronx","2042251","10461","210","18","0","18","3","6"
"2431 FULLER STREET","Bronx","2042256","10461","210","21","0","21","4","5.3"
"2437 LYVERE STREET","Bronx","2042268","10461","210","114","5","119","43","2.8"
"1714 ST PETERS AVENUE","Bronx","2042357","10461","210","9","0","9","3","3"
"1711 MONTGOMERY PLACE","Bronx","2042377","10461","210","63","0","63","3","21"
"1618 BENSON STREET","Bronx","2042415","10461","210","75","0","75","23","3.3"
"1137 EAST TREMONT AVENUE","Bronx","2042422","10460","206","10","0","10","3","3.3"
"1123 EAST TREMONT AVENUE","Bronx","2042428","10460","206","61","9","70","3","23.3"
"1731 VAN BUREN STREET","Bronx","2042528","10460","211","24","0","24","3","8"
"1716 ADAMS STREET","Bronx","2042545","10460","211","9","0","9","3","3"
"1720 ADAMS STREET","Bronx","2042547","10460","211","25","1","26","3","8.7"
"534 MORRIS PARK AVENUE","Bronx","2042576","10460","211","54","0","54","18","3"
"1728 VAN BUREN STREET","Bronx","2042606","10460","211","36","0","36","3","12"
"1711 TAYLOR AVENUE","Bronx","2042638","10460","211","19","1","20","3","6.7"
"591 VAN NEST AVENUE","Bronx","2042686","10460","211","72","0","72","6","12"
"1728 TAYLOR AVENUE","Bronx","2042700","10460","211","16","0","16","3","5.3"
"1604 VAN BUREN STREET","Bronx","2042726","10460","211","8","1","9","3","3"
"1607 TAYLOR AVENUE","Bronx","2042757","10460","211","54","1","55","3","18.3"
"1609 TAYLOR AVENUE","Bronx","2042766","10460","211","54","0","54","3","18"
"1618 TAYLOR AVENUE","Bronx","2042800","10460","211","6","8","14","4","3.5"
"1632 TAYLOR AVENUE","Bronx","2042806","10460","211","14","0","14","4","3.5"
"622 MEAD STREET","Bronx","2042835","10460","211","10","0","10","3","3.3"
"608 VAN NEST AVENUE","Bronx","2042867","10460","211","18","0","18","4","4.5"
"1683 UNIONPORT ROAD","Bronx","2042882","10462","211","20","1","21","5","4.2"
"608 MORRIS PARK AVENUE","Bronx","2042905","10460","211","42","1","43","3","14.3"
"1753 FILLMORE STREET","Bronx","2042908","10460","211","59","0","59","3","19.7"
"1659 HOLLAND AVENUE","Bronx","2043187","10462","211","20","0","20","3","6.7"
"760 VAN NEST AVENUE","Bronx","2043204","10462","211","32","0","32","3","10.7"
"1667 WALLACE AVENUE","Bronx","2043208","10462","211","10","0","10","3","3.3"
"1659 WALLACE AVENUE","Bronx","2043211","10462","211","26","0","26","3","8.7"
"1848 HOLLAND AVENUE","Bronx","2043579","10462","211","11","0","11","3","3.7"
"1868 MATTHEWS AVENUE","Bronx","2043729","10462","211","33","0","33","11","3"
"1847 BRONXDALE AVENUE","Bronx","2043796","10462","211","25","0","25","3","8.3"
"988 SACKETT AVENUE","Bronx","2043904","10462","211","13","0","13","3","4.3"
"1724 COLDEN AVENUE","Bronx","2044801","10462","211","11","0","11","3","3.7"
"957 MORRIS PARK AVENUE","Bronx","2045357","10462","211","16","0","16","3","5.3"
"1846 HONE AVENUE","Bronx","2045556","10461","211","34","0","34","3","11.3"
"1819 WILLIAMSBRIDGE ROAD","Bronx","2045695","10461","211","127","5","132","61","2.2"
"1714 EDISON AVENUE","Bronx","2046083","10461","210","16","0","16","5","3.2"
"1721 HOBART AVENUE","Bronx","2046135","10461","210","87","1","88","37","2.4"
"3039 ROBERTS AVENUE","Bronx","2046230","10461","210","17","1","18","4","4.5"
"1859 MAYFLOWER AVENUE","Bronx","2046452","10461","210","12","0","12","3","4"
"1856 MAYFLOWER AVENUE","Bronx","2046489","10461","210","22","0","22","4","5.5"
"1822 EDISON AVENUE","Bronx","2046567","10461","210","133","0","133","5","26.6"
"3108 ARNOW PLACE","Bronx","2046676","10461","210","15","0","15","3","5"
"1962 EDISON AVENUE","Bronx","2047328","10461","210","10","0","10","3","3.3"
"2905 WILKINSON AVENUE","Bronx","2047492","10461","210","14","0","14","3","4.7"
"2883 EAST 195 STREET","Bronx","2047579","10461","210","19","0","19","4","4.8"
"2845 EAST 196 STREET","Bronx","2047635","10461","210","26","1","27","4","6.8"
"2135 CONTINENTAL AVENUE","Bronx","2047638","10461","210","33","6","39","4","9.8"
"2932 EAST 194 STREET","Bronx","2047651","10461","210","15","0","15","3","5"
"2023 COLONIAL AVENUE","Bronx","2047747","10461","210","86","1","87","41","2.1"
"2037 BURR AVENUE","Bronx","2047775","10461","210","56","0","56","3","18.7"
"664 SAGAMORE STREET","Bronx","2047837","10462","211","27","0","27","3","9"
"2009 CRUGER AVENUE","Bronx","2047887","10462","211","133","6","139","41","3.4"
"1936 WALLACE AVENUE","Bronx","2047994","10462","211","24","0","24","3","8"
"1907 BOGART AVENUE","Bronx","2048197","10462","211","41","0","41","7","5.9"
"2040 BRONXDALE AVENUE","Bronx","2048777","10462","211","198","1","199","54","3.7"
"2075 WALLACE AVENUE","Bronx","2048821","10462","211","702","1","703","189","3.7"
"2031 TOMLINSON AVENUE","Bronx","2049141","10461","211","14","0","14","4","3.5"
"2145 MATTHEWS AVENUE","Bronx","2049438","10462","211","111","1","112","51","2.2"
"1032 ESPLANADE","Bronx","2049563","10461","211","10","0","10","3","3.3"
"2241 HOLLAND AVENUE","Bronx","2050015","10467","211","136","2","138","49","2.8"
"2337 WALLACE AVENUE","Bronx","2050081","10467","211","19","0","19","3","6.3"
"2316 WALLACE AVENUE","Bronx","2050093","10467","211","233","0","233","33","7.1"
"2315 ESPLANADE","Bronx","2050323","10469","211","9","0","9","3","3"
"2554 HOLLAND AVENUE","Bronx","2051388","10467","211","44","0","44","8","5.5"
"774 ALLERTON AVENUE","Bronx","2051508","10467","211","217","3","220","46","4.8"
"2559 COLDEN AVENUE","Bronx","2051658","10469","211","18","0","18","4","4.5"
"977 MACE AVENUE","Bronx","2051679","10469","211","38","0","38","3","12.7"
"1143 MACE AVENUE","Bronx","2052078","10469","211","19","0","19","3","6.3"
"2544 YATES AVENUE","Bronx","2052096","10469","211","12","0","12","4","3"
"2551 HERING AVENUE","Bronx","2052115","10469","211","29","163","192","3","64"
"2531 HERING AVENUE","Bronx","2052122","10469","211","13","0","13","3","4.3"
"1523 MACE AVENUE","Bronx","2053032","10469","211","10","0","10","3","3.3"
"2758 CRUGER AVENUE","Bronx","2053607","10467","211","119","0","119","54","2.2"
"2708 HOLLAND AVENUE","Bronx","2053646","10467","211","19","0","19","3","6.3"
"2749 WALLACE AVENUE","Bronx","2053676","10467","211","51","0","51","4","12.8"
"2721 WALLACE AVENUE","Bronx","2053690","10467","211","31","0","31","4","7.8"
"788 ARNOW AVENUE","Bronx","2053720","10467","211","273","2","275","55","5"
"2735 BARNES AVENUE","Bronx","2053731","10467","211","12","0","12","4","3"
"2723 BARNES AVENUE","Bronx","2053736","10467","211","129","1","130","59","2.2"
"2715 BARNES AVENUE","Bronx","2053737","10467","211","24","0","24","4","6"
"2711 BARNES AVENUE","Bronx","2053738","10467","211","21","0","21","4","5.3"
"2758 BARNES AVENUE","Bronx","2053756","10467","211","16","0","16","3","5.3"
"826 ARNOW AVENUE","Bronx","2053801","10467","211","58","0","58","4","14.5"
"3054 BARKER AVENUE","Bronx","2054754","10467","212","10","0","10","3","3.3"
"725 ARNOW AVENUE","Bronx","2054801","10467","211","19","4","23","4","5.8"
"2911 HOLLAND AVENUE","Bronx","2054837","10467","211","131","0","131","5","26.2"
"809 ARNOW AVENUE","Bronx","2054893","10467","211","19","13","32","4","8"
"831 ARNOW AVENUE","Bronx","2054900","10467","211","43","0","43","7","6.1"
"2945 RADCLIFF AVENUE","Bronx","2054934","10469","211","21","0","21","3","7"
"1407 ARNOW AVENUE","Bronx","2055431","10469","211","16","0","16","4","4"
"1450 EAST GUN HILL ROAD","Bronx","2055541","10469","211","27","0","27","9","3"
"1466 EAST GUN HILL ROAD","Bronx","2055544","10469","211","110","0","110","30","3.7"
"767 ADEE AVENUE","Bronx","2055596","10467","212","103","0","103","3","34.3"
"3034 HOLLAND AVENUE","Bronx","2055609","10467","212","136","1","137","13","10.5"
"3042 HOLLAND AVENUE","Bronx","2055611","10467","212","124","0","124","13","9.5"
"3046 HOLLAND AVENUE","Bronx","2055612","10467","212","122","0","122","13","9.4"
"3028 WALLACE AVENUE","Bronx","2055638","10467","212","25","0","25","3","8.3"
"805 ADEE AVENUE","Bronx","2055662","10467","212","45","0","45","4","11.3"
"3015 MATTHEWS AVENUE","Bronx","2055689","10467","212","61","0","61","4","15.3"
"3011 MATTHEWS AVENUE","Bronx","2055691","10467","212","12","0","12","4","3"
"3038 BRONXWOOD AVENUE","Bronx","2055756","10469","212","47","0","47","7","6.7"
"3019 COLDEN AVENUE","Bronx","2055809","10469","212","33","0","33","3","11"
"3038 COLDEN AVENUE","Bronx","2055831","10469","212","34","2","36","3","12"
"3011 PAULDING AVENUE","Bronx","2055849","10469","212","33","0","33","7","4.7"
"3018 PAULDING AVENUE","Bronx","2055860","10469","212","22","0","22","7","3.1"
"3019 WILSON AVENUE","Bronx","2056074","10469","211","22","0","22","3","7.3"
"655 BURKE AVENUE","Bronx","2056168","10467","212","261","1","262","59","4.4"
"3234 WHITE PLAINS ROAD","Bronx","2056241","10467","212","14","0","14","3","4.7"
"3233 CRUGER AVENUE","Bronx","2056251","10467","212","50","0","50","3","16.7"
"756 SOUTH OAK DRIVE","Bronx","2056274","10467","212","32","0","32","7","4.6"
"768 SOUTH OAK DRIVE","Bronx","2056279","10467","212","23","0","23","3","7.7"
"3209 WALLACE AVENUE","Bronx","2056280","10467","212","26","2","28","4","7"
"3310 WHITE PLAINS ROAD","Bronx","2056305","10467","212","71","2","73","3","24.3"
"736 BARTHOLDI STREET","Bronx","2056330","10467","212","12","0","12","3","4"
"780 BARTHOLDI STREET","Bronx","2056378","10467","212","19","0","19","3","6.3"
"3214 BRONXWOOD AVENUE","Bronx","2056483","10469","212","11","0","11","3","3.7"
"3226 BRONXWOOD AVENUE","Bronx","2056485","10469","212","325","2","327","17","19.2"
"3235 PAULDING AVENUE","Bronx","2056578","10469","212","9","0","9","3","3"
"1157 BURKE AVENUE","Bronx","2056716","10469","211","30","0","30","3","10"
"3341 BARKER AVENUE","Bronx","2056846","10467","212","48","0","48","5","9.6"
"3435 OLINVILLE AVENUE","Bronx","2056937","10467","212","93","40","133","54","2.5"
"3311 COLDEN AVENUE","Bronx","2057080","10469","212","66","0","66","5","13.2"
"3332 PAULDING AVENUE","Bronx","2057199","10469","212","29","0","29","5","5.8"
"3560 OLINVILLE AVENUE","Bronx","2057282","10467","212","186","7","193","85","2.3"
"3616 BRONX BOULEVARD","Bronx","2057321","10467","212","65","0","65","7","9.3"
"3645 OLINVILLE AVENUE","Bronx","2057346","10467","212","15","0","15","3","5"
"3643 OLINVILLE AVENUE","Bronx","2057347","10467","212","6","3","9","3","3"
"3641 OLINVILLE AVENUE","Bronx","2057348","10467","212","10","0","10","3","3.3"
"3750 BRONX BOULEVARD","Bronx","2057434","10467","212","147","2","149","43","3.5"
"3756 OLINVILLE AVENUE","Bronx","2057473","10467","212","19","0","19","5","3.8"
"3765 WILLETT AVENUE","Bronx","2057484","10467","212","26","0","26","3","8.7"
"3830 BRONX BOULEVARD","Bronx","2057548","10467","212","149","3","152","49","3.1"
"3800 CARPENTER AVENUE","Bronx","2057563","10467","212","211","3","214","55","3.9"
"679 EAST 220 STREET","Bronx","2057630","10467","212","14","0","14","4","3.5"
"3857 WHITE PLAINS ROAD","Bronx","2057658","10467","212","62","2","64","7","9.1"
"3553 HOLLAND AVENUE","Bronx","2057706","10467","212","8","2","10","3","3.3"
"3553 CARLISLE PLACE","Bronx","2057751","10467","212","11","0","11","3","3.7"
"764 EAST 213 STREET","Bronx","2057766","10467","212","23","0","23","3","7.7"
"3535 BARNES AVENUE","Bronx","2057769","10467","212","34","12","46","3","15.3"
"791 EAST 211 STREET","Bronx","2057775","10467","212","34","1","35","5","7"
"3602 HOLLAND AVENUE","Bronx","2057803","10467","212","22","3","25","3","8.3"
"744 EAST 214 STREET","Bronx","2057811","10467","212","27","0","27","8","3.4"
"780 EAST  214 STREET","Bronx","2057818","10467","212","70","0","70","7","10"
"771 EAST 213 STREET","Bronx","2057823","10467","212","93","0","93","7","13.3"
"741 EAST 213 STREET","Bronx","2057834","10467","212","17","0","17","3","5.7"
"708 EAST 215 STREET","Bronx","2057839","10467","212","40","0","40","5","8"
"709 EAST 214 STREET","Bronx","2057852","10467","212","14","0","14","4","3.5"
"3642 HOLLAND AVENUE","Bronx","2057859","10467","212","72","0","72","12","6"
"3644 HOLLAND AVENUE","Bronx","2057860","10467","212","42","3","45","12","3.8"
"769 EAST 214 STREET","Bronx","2057886","10467","212","50","0","50","6","8.3"
"744 EAST  216 STREET","Bronx","2057908","10467","212","11","0","11","3","3.7"
"729 EAST 215 STREET","Bronx","2057916","10467","212","229","5","234","3","78"
"755 EAST 218 STREET","Bronx","2058037","10467","212","14","0","14","4","3.5"
"711 EAST 218 STREET","Bronx","2058054","10467","212","30","0","30","3","10"
"726 EAST  219 STREET","Bronx","2058063","10467","212","9","0","9","3","3"
"737 EAST 219 STREET","Bronx","2058088","10467","212","63","2","65","6","10.8"
"736 EAST  221 STREET","Bronx","2058148","10467","212","23","3","26","3","8.7"
"738 EAST  221 STREET","Bronx","2058149","10467","212","62","0","62","3","20.7"
"754 EAST 221 STREET","Bronx","2058154","10467","212","21","0","21","3","7"
"3610 BARNES AVENUE","Bronx","2058244","10467","212","105","2","107","8","13.4"
"826 EAST 214 STREET","Bronx","2058249","10467","212","37","0","37","4","9.3"
"854 EAST  214 STREET","Bronx","2058258","10467","212","89","3","92","3","30.7"
"3603 BRONXWOOD AVENUE","Bronx","2058261","10469","212","54","0","54","5","10.8"
"822 EAST  215 STREET","Bronx","2058300","10467","212","37","0","37","3","12.3"
"832 EAST 215 STREET","Bronx","2058303","10467","212","22","0","22","3","7.3"
"844 EAST 216 STREET","Bronx","2058364","10467","212","37","0","37","3","12.3"
"820 EAST  218 STREET","Bronx","2058439","10467","212","57","0","57","4","14.3"
"841 EAST 218 STREET","Bronx","2058466","10467","212","32","0","32","6","5.3"
"827 EAST 218 STREET","Bronx","2058470","10467","212","26","4","30","8","3.8"
"3816 BARNES AVENUE","Bronx","2058533","10467","212","23","0","23","7","3.3"
"870 EAST 220 STREET","Bronx","2058557","10467","212","18","0","18","4","4.5"
"829 EAST 220 STREET","Bronx","2058575","10467","212","14","0","14","3","4.7"
"864 EAST 221 STREET","Bronx","2058602","10467","212","19","2","21","7","3"
"836 EAST 222 STREET","Bronx","2058637","10467","212","16","0","16","3","5.3"
"900A EAST  213 STREET","Bronx","2058739","10469","212","12","0","12","4","3"
"3612 BRONXWOOD AVENUE","Bronx","2058787","10469","212","27","1","28","3","9.3"
"941 EAST  214 STREET","Bronx","2058820","10469","212","0","9","9","3","3"
"914 EAST 217 STREET","Bronx","2058922","10469","212","14","0","14","4","3.5"
"901 EAST 217 STREET","Bronx","2058964","10469","212","113","0","113","30","3.8"
"3620 PAULDING AVENUE","Bronx","2059344","10469","212","18","16","34","3","11.3"
"1005 EAST 217 STREET","Bronx","2059520","10469","212","34","0","34","4","8.5"
"1112 EAST 211 STREET","Bronx","2059739","10469","212","16","0","16","3","5.3"
"1314 OAKLEY STREET","Bronx","2059931","10469","212","22","0","22","4","5.5"
"1303 NEEDHAM AVENUE","Bronx","2059949","10469","212","13","4","17","5","3.4"
"1312 NEEDHAM AVENUE","Bronx","2059954","10469","212","14","0","14","3","4.7"
"1417 NEEDHAM AVENUE","Bronx","2060182","10469","212","32","0","32","3","10.7"
"3437 EASTCHESTER ROAD","Bronx","2060214","10469","212","35","2","37","8","4.6"
"3542 EASTCHESTER ROAD","Bronx","2060330","10469","212","12","0","12","3","4"
"3347 FISH AVENUE","Bronx","2060618","10469","212","12","0","12","4","3"
"3319 FISH AVENUE","Bronx","2060632","10469","212","21","0","21","3","7"
"3355 SEYMOUR AVENUE","Bronx","2060678","10469","212","27","1","28","4","7"
"3347 SEYMOUR AVENUE","Bronx","2060682","10469","212","12","0","12","4","3"
"3326 FISH AVENUE","Bronx","2060719","10469","212","17","0","17","3","5.7"
"3357 FENTON AVENUE","Bronx","2060744","10469","212","9","0","9","3","3"
"3349 FENTON AVENUE","Bronx","2060747","10469","212","47","7","54","3","18"
"3231 SEYMOUR AVENUE","Bronx","2060900","10469","212","18","0","18","4","4.5"
"1352 BURKE AVENUE","Bronx","2061697","10469","212","10","0","10","3","3.3"
"2962 WICKHAM AVENUE","Bronx","2062589","10469","212","44","7","51","3","17"
"2960 WICKHAM AVENUE","Bronx","2062590","10469","212","16","0","16","3","5.3"
"3972 BRONX BOULEVARD","Bronx","2062853","10466","212","23","0","23","5","4.6"
"627 EAST 222 STREET","Bronx","2062901","10467","212","26","0","26","7","3.7"
"3939 WHITE PLAINS ROAD","Bronx","2062933","10466","212","18","0","18","3","6"
"687 EAST 223 STREET","Bronx","2062936","10466","212","38","1","39","3","13"
"649 EAST 223 STREET","Bronx","2062947","10466","212","18","0","18","3","6"
"654 EAST 224 STREET","Bronx","2062963","10466","212","98","0","98","47","2.1"
"667 EAST 224 STREET","Bronx","2062981","10466","212","37","0","37","3","12.3"
"685 EAST 225 STREET","Bronx","2063011","10466","212","182","1","183","46","4"
"662 EAST 226 STREET","Bronx","2063036","10466","212","44","1","45","3","15"
"658 EAST 227 STREET","Bronx","2063068","10466","212","10","0","10","3","3.3"
"687 EAST 226 STREET","Bronx","2063075","10466","212","41","0","41","4","10.3"
"4036 LOWERRE PLACE","Bronx","2063090","10466","212","20","0","20","4","5"
"4043 LOWERRE PLACE","Bronx","2063098","10466","212","18","1","19","3","6.3"
"4059 WHITE PLAINS ROAD","Bronx","2063133","10466","212","18","0","18","4","4.5"
"645 EAST 228 STREET","Bronx","2063151","10466","212","52","0","52","5","10.4"
"647 EAST 229 STREET","Bronx","2063195","10466","212","18","0","18","3","6"
"674 EAST 231 STREET","Bronx","2063249","10466","212","17","0","17","4","4.3"
"680 EAST 231 STREET","Bronx","2063250","10466","212","16","0","16","5","3.2"
"694 EAST 231 STREET","Bronx","2063253","10466","212","13","3","16","4","4"
"721 EAST 222 STREET","Bronx","2063314","10467","212","48","0","48","5","9.6"
"723 EAST 223 STREET","Bronx","2063365","10466","212","17","0","17","4","4.3"
"769 EAST 224 STREET","Bronx","2063391","10466","212","35","0","35","7","5"
"755 EAST 224 STREET","Bronx","2063397","10466","212","25","0","25","7","3.6"
"753 EAST  224 STREET","Bronx","2063398","10466","212","31","1","32","7","4.6"
"751 EAST 224 STREET","Bronx","2063399","10466","212","45","0","45","7","6.4"
"4009 BARNES AVENUE","Bronx","2063453","10466","212","11","0","11","3","3.7"
"753 EAST 226 STREET","Bronx","2063462","10466","212","26","2","28","7","4"
"711 EAST 228 STREET","Bronx","2063559","10466","212","51","0","51","16","3.2"
"711 EAST 230 STREET","Bronx","2063646","10466","212","116","1","117","42","2.8"
"718 EAST 232 STREET","Bronx","2063682","10466","212","16","0","16","3","5.3"
"756 EAST 232 STREET","Bronx","2063686","10466","212","18","0","18","3","6"
"836 EAST  223 STREET","Bronx","2063758","10466","212","12","0","12","3","4"
"3942 BARNES AVENUE","Bronx","2063810","10466","212","28","0","28","7","4"
"812 EAST 226 STREET","Bronx","2063899","10466","212","20","0","20","6","3.3"
"801 EAST  226 STREET","Bronx","2063936","10466","212","44","0","44","8","5.5"
"826 EAST 227 STREET","Bronx","2063949","10466","212","29","0","29","5","5.8"
"841 EAST 227 STREET","Bronx","2063971","10466","212","22","0","22","5","4.4"
"830 EAST 230 STREET","Bronx","2064095","10466","212","65","0","65","4","16.3"
"836 EAST 230 STREET","Bronx","2064098","10466","212","17","0","17","4","4.3"
"4126 BARNES AVENUE","Bronx","2064141","10466","212","10","0","10","3","3.3"
"869 EAST 231 STREET","Bronx","2064172","10466","212","19","0","19","5","3.8"
"824 EAST 232 STREET","Bronx","2064200","10466","212","20","0","20","5","4"
"860 EAST 232 STREET","Bronx","2064212","10466","212","39","3","42","4","10.5"
"847 EAST 232 STREET","Bronx","2064225","10466","212","25","0","25","6","4.2"
"806 EAST 233 STREET","Bronx","2064245","10466","212","15","0","15","3","5"
"916 EAST 223 STREET","Bronx","2064278","10466","212","33","0","33","3","11"
"901 EAST 223 STREET","Bronx","2064327","10466","212","12","0","12","3","4"
"916 EAST 224 STREET","Bronx","2064333","10466","212","65","0","65","4","16.3"
"924 EAST 224 STREET","Bronx","2064336","10466","212","37","0","37","4","9.3"
"936 EAST 224 STREET","Bronx","2064340","10466","212","14","0","14","4","3.5"
"961 EAST  224 STREET","Bronx","2064367","10466","212","40","2","42","4","10.5"
"950 EAST 225 STREET","Bronx","2064410","10466","212","65","1","66","5","13.2"
"956 EAST 225 STREET","Bronx","2064412","10466","212","21","1","22","3","7.3"
"3988 BRONXWOOD AVENUE","Bronx","2064442","10466","212","23","21","44","3","14.7"
"4005 PAULDING AVENUE","Bronx","2064467","10466","212","10","0","10","3","3.3"
"940 EAST 227 STREET","Bronx","2064504","10466","212","0","21","21","3","7"
"966 EAST  227 STREET","Bronx","2064511","10466","212","14","0","14","3","4.7"
"962 EAST 228 STREET","Bronx","2064563","10466","212","10","0","10","3","3.3"
"915 EAST 229 STREET","Bronx","2064639","10466","212","64","3","67","4","16.8"
"1038 EAST 224 STREET","Bronx","2064889","10466","212","12","0","12","3","4"
"1056 EAST  226 STREET","Bronx","2064984","10466","212","20","0","20","3","6.7"
"4008 PAULDING AVENUE","Bronx","2065004","10466","212","16","0","16","5","3.2"
"1047 EAST 227 STREET","Bronx","2065047","10466","212","7","2","9","3","3"
"1052 EAST 232 STREET","Bronx","2065319","10466","212","56","0","56","6","9.3"
"3424 GRACE AVENUE","Bronx","2065541","10469","212","11","0","11","3","3.7"
"1208 EAST 224 STREET","Bronx","2065773","10466","212","15","0","15","3","5"
"3689 EASTCHESTER ROAD","Bronx","2065831","10466","212","47","0","47","3","15.7"
"4180 LACONIA AVENUE","Bronx","2066094","10466","212","9","0","9","3","3"
"2232 LIGHT STREET","Bronx","2066461","10466","212","18","0","18","3","6"
"2236 LIGHT STREET","Bronx","2066463","10466","212","15","0","15","3","5"
"3910 SETON AVENUE","Bronx","2066840","10466","212","148","1","149","6","24.8"
"3959 AMUNDSON AVENUE","Bronx","2066868","10466","212","18","0","18","3","6"
"4018 PRATT AVENUE","Bronx","2067029","10466","212","37","0","37","3","12.3"
"1800 EDENWALD AVENUE","Bronx","2067267","10466","212","114","0","114","3","38"
"4014 AMUNDSON AVENUE","Bronx","2067947","10466","212","16","0","16","3","5.3"
"687 EAST 234 STREET","Bronx","2068071","10466","212","31","0","31","7","4.4"
"685 EAST 234 STREET","Bronx","2068072","10466","212","15","34","49","6","8.2"
"683 EAST 234 STREET","Bronx","2068073","10466","212","23","1","24","6","4"
"655 EAST 234 STREET","Bronx","2068076","10466","212","203","0","203","55","3.7"
"4240 BYRON AVENUE","Bronx","2068188","10466","212","28","0","28","7","4"
"730 EAST 236 STREET","Bronx","2068245","10466","212","202","3","205","78","2.6"
"1733 EDENWALD AVENUE","Bronx","2068370","10466","212","9","0","9","3","3"
"4247 DIGNEY AVENUE","Bronx","2068449","10466","212","12","0","12","4","3"
"4118 BRUNER AVENUE","Bronx","2068704","10466","212","26","0","26","3","8.7"
"4218 EDSON AVENUE","Bronx","2069081","10466","212","10","0","10","3","3.3"
"633 EAST 236 STREET","Bronx","2069628","10466","212","15","0","15","3","5"
"4383 MATILDA AVENUE","Bronx","2069737","10466","212","38","0","38","7","5.4"
"4381 MATILDA AVENUE","Bronx","2069738","10466","212","42","0","42","7","6"
"4305 FURMAN AVENUE","Bronx","2069782","10466","212","131","0","131","43","3"
"731 EAST 236 STREET","Bronx","2069808","10466","212","50","0","50","3","16.7"
"4381 BARNES AVENUE","Bronx","2069914","10466","212","13","0","13","4","3.3"
"4360 BAYCHESTER AVENUE","Bronx","2070413","10466","212","164","1","165","69","2.4"
"609 NEREID AVENUE","Bronx","2070566","10470","212","20","0","20","5","4"
"606 EAST  239 STREET","Bronx","2070575","10470","212","12","0","12","4","3"
"4429 CARPENTER AVENUE","Bronx","2070588","10470","212","45","0","45","7","6.4"
"4401 CARPENTER AVENUE","Bronx","2070598","10470","212","15","2","17","3","5.7"
"4439 FURMAN AVENUE","Bronx","2070730","10466","212","60","1","61","5","12.2"
"749 NEREID AVENUE","Bronx","2070775","10466","212","89","0","89","25","3.6"
"4511 MATILDA AVENUE","Bronx","2070910","10470","212","16","0","16","3","5.3"
"4635 CARPENTER AVENUE","Bronx","2070951","10470","212","0","12","12","3","4"
"4632 CARPENTER AVENUE","Bronx","2070973","10470","212","200","1","201","21","9.6"
"681 EAST 239 STREET","Bronx","2071028","10470","212","28","0","28","4","7"
"4556 RICHARDSON AVENUE","Bronx","2071042","10470","212","36","0","36","3","12"
"4566 RICHARDSON AVENUE","Bronx","2071044","10470","212","40","0","40","5","8"
"4562 WHITE PLAINS ROAD","Bronx","2071134","10470","212","16","1","17","3","5.7"
"4400 WICKHAM AVENUE","Bronx","2071196","10466","212","68","1","69","23","3"
"4435 MUNDY LANE","Bronx","2071605","10466","212","36","0","36","3","12"
"4731 RICHARDSON AVENUE","Bronx","2071751","10470","212","30","1","31","4","7.8"
"4727 WHITE PLAINS ROAD","Bronx","2071767","10470","212","79","1","80","14","5.7"
"715 CRANFORD AVENUE","Bronx","2071833","10470","212","15","1","16","4","4"
"718 PENFIELD STREET","Bronx","2071873","10470","212","24","0","24","7","3.4"
"719 EAST  242 STREET","Bronx","2071912","10470","212","197","1","198","4","49.5"
"717 EAST 242 STREET","Bronx","2071913","10470","212","61","0","61","4","15.3"
"708 EAST 243 STREET","Bronx","2071916","10470","212","242","3","245","50","4.9"
"740 EAST 243 STREET","Bronx","2071921","10470","212","320","6","326","72","4.5"
"853 EAST 242 STREET","Bronx","2072064","10470","212","9","1","10","3","3.3"
"956 CRANFORD AVENUE","Bronx","2072245","10466","212","37","0","37","3","12.3"
"879 CRANFORD AVENUE","Bronx","2072282","10466","212","47","0","47","3","15.7"
"1225 HOLLYWOOD AVENUE","Bronx","2073333","10461","210","28","0","28","4","7"
"1367 ELLISON AVENUE","Bronx","2073494","10461","210","29","0","29","4","7.3"
"2915 LA SALLE AVENUE","Bronx","2073762","10461","210","107","0","107","5","21.4"
"1426 EDWARDS AVENUE","Bronx","2074082","10461","210","30","0","30","6","5"
"2897 HARRINGTON AVENUE","Bronx","2074258","10461","210","8","3","11","3","3.7"
"2806 WELLMAN AVENUE","Bronx","2074333","10461","210","11","0","11","3","3.7"
"1539 MAYFLOWER AVENUE","Bronx","2074389","10461","210","99","5","104","4","26"
"1666 OHM AVENUE","Bronx","2075950","10465","210","23","0","23","3","7.7"
"1075 EDISON AVENUE","Bronx","2076434","10465","210","213","2","215","28","7.7"
"1055 HUNTINGTON AVENUE","Bronx","2079789","10465","210","15","0","15","3","5"
"2881 PHILIP AVENUE","Bronx","2079895","10465","210","12","0","12","4","3"
"832 CALHOUN AVENUE","Bronx","2079991","10465","210","32","0","32","4","8"
"185 CITY ISLAND AVENUE","Bronx","2081930","10464","210","73","8","81","6","13.5"
"452 CITY ISLAND AVENUE","Bronx","2082784","10464","210","48","1","49","6","8.2"
"456 CITY ISLAND AVENUE","Bronx","2082786","10464","210","103","0","103","6","17.2"
"202 WEST 236 STREET","Bronx","2083690","10463","208","25","0","25","7","3.6"
"3425 KINGSBRIDGE AVENUE","Bronx","2083716","10463","208","185","0","185","55","3.4"
"3251 CAMBRIDGE AVENUE","Bronx","2084078","10463","208","10","0","10","3","3.3"
"3241 JOHNSON AVENUE","Bronx","2084108","10463","208","9","0","9","3","3"
"413 EAST 173 STREET","Bronx","2086669","10457","203","9","0","9","3","3"
"2464 BEAUMONT AVENUE","Bronx","2086804","10458","206","20","3","23","6","3.8"
"943 ARNOW AVENUE","Bronx","2087293","10469","211","10","0","10","3","3.3"
"3520 CORSA AVENUE","Bronx","2087328","10469","212","135","0","135","3","45"
"1488 HICKS STREET","Bronx","2087331","10469","212","148","0","148","3","49.3"
"2956 RANDALL AVENUE","Bronx","2087434","10465","210","10","0","10","3","3.3"
"364 HUNTINGTON AVENUE","Bronx","2087475","10465","210","9","0","9","3","3"
"368 HUNTINGTON AVENUE","Bronx","2087476","10465","210","19","1","20","3","6.7"
"391 HUNTINGTON AVENUE","Bronx","2087484","10465","210","11","0","11","3","3.7"
"383 HUNTINGTON AVENUE","Bronx","2087486","10465","210","11","0","11","3","3.7"
"541 EDISON AVE","Bronx","2087936","10465","210","16","0","16","3","5.3"
"1934 HOLLAND AVENUE","Bronx","2088074","10462","211","24","1","25","3","8.3"
"1936 HOLLAND AVENUE","Bronx","2088075","10462","211","13","1","14","3","4.7"
"1350 PROSPECT AVENUE","Bronx","2088306","10459","203","26","0","26","3","8.7"
"4217 THROGS NECK EXPRESSWAY","Bronx","2088636","10465","210","11","1","12","3","4"
"3374 CORSA AVENUE","Bronx","2090177","10469","212","9","0","9","3","3"
"3019 ELY AVENUE","Bronx","2090189","10469","212","11","1","12","3","4"
"2971 EDSON AVENUE","Bronx","2090204","10469","212","12","0","12","3","4"
"3406 BRUNER AVENUE","Bronx","2090224","10469","212","11","2","13","3","4.3"
"1112 E. 225 STREET","Bronx","2090241","10466","212","0","13","13","3","4.3"
"1118 EAST  225 STREET","Bronx","2090245","10466","212","10","1","11","3","3.7"
"4602 BRONX BOULEVARD","Bronx","2090266","10470","212","28","0","28","3","9.3"
"2173 NEW ENGLAND THRWY","Bronx","2090285","10475","212","9","0","9","3","3"
"936 INTERVALE AVE","Bronx","2090351","10459","202","131","0","131","27","4.9"
"964 MORRIS AVENUE","Bronx","2090414","10456","204","113","0","113","56","2"
"1388 BRISTOW STREET","Bronx","2090459","10459","203","36","4","40","3","13.3"
"3699 EASTCHESTER ROAD","Bronx","2090555","10466","212","11","0","11","3","3.7"
"430 EAST  138 STREET","Bronx","2091015","10454","201","79","0","79","37","2.1"
"448 EAST  147 STREET","Bronx","2091093","10455","201","62","0","62","16","3.9"
"281 EAST  149 STREET","Bronx","2091155","10451","201","86","0","86","17","5.1"
"370 CYPRESS AVENUE","Bronx","2091297","10454","201","102","6","108","21","5.1"
"728 EAST  142 STREET","Bronx","2091302","10454","201","9","0","9","3","3"
"702 EAGLE AVENUE","Bronx","2091324","10455","201","18","0","18","4","4.5"
"3206 OXFORD AVENUE","Bronx","2091878","10463","208","36","8","44","3","14.7"
"900 FOX STREET","Bronx","2092012","10459","202","85","2","87","20","4.3"
"995 EAST  167 STREET","Bronx","2092029","10459","203","50","0","50","12","4.2"
"1934 DR M L KING JR BOULEVARD","Bronx","2092062","10453","205","76","4","80","21","3.8"
"1928 UNIVERSITY AVENUE","Bronx","2092063","10453","205","81","4","85","21","4"
"711 CROTONA PARK NORTH","Bronx","2092144","10457","206","16","0","16","3","5.3"
"2376 HOFFMAN STREET","Bronx","2092237","10458","206","63","0","63","8","7.9"
"617 EAST  179 STREET","Bronx","2092249","10457","206","38","0","38","8","4.8"
"2380 HUGHES AVENUE","Bronx","2092257","10458","206","98","0","98","18","5.4"
"2407 VALENTINE AVENUE","Bronx","2092396","10458","205","53","0","53","9","5.9"
"2411 GRAND AVENUE","Bronx","2092422","10468","207","18","1","19","5","3.8"
"2485 DEVOE TERRACE","Bronx","2092429","10468","207","139","1","140","36","3.9"
"3021 HEATH AVE","Bronx","2092469","10463","208","215","0","215","26","8.3"
"225 REAR EAST  203 STREET","Bronx","2092506","10458","207","14","0","14","3","4.7"
"3488 WEBSTER AVENUE","Bronx","2092542","10467","207","69","1","70","15","4.7"
"512 SOUNDVIEW AVENUE","Bronx","2092620","10473","209","8","3","11","3","3.7"
"1139 NOBLE AVENUE","Bronx","2092821","10472","209","14","0","14","3","4.7"
"2164 POWELL AVENUE","Bronx","2092863","10462","209","67","0","67","12","5.6"
"1331 BEACH AVENUE","Bronx","2092896","10472","209","42","0","42","3","14"
"1319 BEACH AVENUE","Bronx","2092898","10472","209","10","1","11","3","3.7"
"367 BRONX PARK AVENUE","Bronx","2092917","10460","206","18","0","18","3","6"
"2593 ST RAYMOND AVENUE","Bronx","2093104","10461","210","13","1","14","4","3.5"
"2601 PONTON AVENUE","Bronx","2093112","10461","210","95","0","95","3","31.7"
"1957 LURTING AVENUE","Bronx","2093258","10461","211","24","0","24","5","4.8"
"2701 BARKER AVENUE","Bronx","2093451","10467","211","218","1","219","102","2.1"
"600 BRITTON STREET","Bronx","2093456","10467","211","199","1","200","81","2.5"
"2859 BARKER AVENUE","Bronx","2093463","10467","211","262","4","266","88","3"
"2753 TENBROECK AVENUE","Bronx","2093474","10469","211","29","0","29","3","9.7"
"2922 BARNES AVENUE","Bronx","2093477","10467","211","127","11","138","69","2"
"763 EAST  217 STREET","Bronx","2093557","10467","212","50","3","53","4","13.3"
"3017 EASTCHESTER ROAD","Bronx","2093643","10469","212","57","0","57","4","14.3"
"955 EAST  233 STREET","Bronx","2093766","10466","212","44","0","44","4","11"
"662 EAST  236 STREET","Bronx","2093770","10466","212","61","0","61","3","20.3"
"4641 WHITE PLAINS ROAD","Bronx","2093819","10470","212","50","0","50","9","5.6"
"4643 WHITEPLAINS ROAD","Bronx","2093820","10470","212","18","0","18","6","3"
"866 EAST 221 STREET","Bronx","2094188","10467","212","34","1","35","7","5"
"221 EAST TREMONT AVENUE","Bronx","2094515","10457","205","34","3","37","4","9.3"
"2523 BARNES AVENUE","Bronx","2095040","10467","211","87","0","87","7","12.4"
"2179 NEW ENGLAND THRUWAY","Bronx","2095420","10475","212","36","0","36","3","12"
"1370 ZEREGA AVENUE","Bronx","2095483","10462","210","16","0","16","3","5.3"
"789 ST ANNS AVENUE","Bronx","2096530","10456","201","16","3","19","4","4.8"
"855A UNDERHILL AVENUE","Bronx","2096828","10473","209","29","0","29","3","9.7"
"843A UNDERHILL AVENUE","Bronx","2096834","10473","209","16","0","16","3","5.3"
"1219 WOODYCREST AVENUE","Bronx","2097932","10452","204","14","0","14","3","4.7"
"1181 SHERMAN AVENUE","Bronx","2098340","10456","204","139","2","141","43","3.3"
"1199 NELSON AVENUE","Bronx","2098352","10452","204","10","0","10","3","3.3"
"2668 MILES AVENUE","Bronx","2099296","10465","210","24","0","24","3","8"
"1096 WOODYCREST AVENUE","Bronx","2099370","10452","204","9","1","10","3","3.3"
"507 TINTON AVENUE","Bronx","2099679","10455","201","13","0","13","3","4.3"
"513 TINTON AVENUE","Bronx","2099686","10455","201","32","0","32","3","10.7"
"585 EAST  189 STREET","Bronx","2099894","10458","206","25","6","31","4","7.8"
"1357 EAST  224 STREET","Bronx","2100030","10466","212","10","0","10","3","3.3"
"721 CRANFORD AVENUE","Bronx","2100039","10470","212","35","0","35","4","8.8"
"975 CAULDWELL AVENUE","Bronx","2100800","10456","203","19","0","19","3","6.3"
"725 EAST  182 STREET","Bronx","2101202","10457","206","11","0","11","3","3.7"
"718 GARDEN STREET","Bronx","2101295","10457","206","86","0","86","3","28.7"
"1066 WOODYCREST AVENUE","Bronx","2101559","10452","204","11","0","11","3","3.7"
"1439 VYSE AVENUE","Bronx","2102263","10459","203","18","0","18","3","6"
"1447 VYSE AVENUE","Bronx","2102267","10459","203","25","0","25","3","8.3"
"1235 HOE AVENUE","Bronx","2102271","10459","203","10","0","10","3","3.3"
"1811 HUNT AVENUE","Bronx","2102296","10462","211","26","1","27","3","9"
"944 JENNINGS STREET","Bronx","2102389","10460","203","174","1","175","84","2.1"
"2124 CROTONA AVENUE","Bronx","2102390","10457","206","189","8","197","86","2.3"
"280 DAVIS AVENUE","Bronx","2102497","10465","210","14","0","14","3","4.7"
"1817 HUNT AVENUE","Bronx","2102809","10462","211","11","0","11","3","3.7"
"3436 EASTCHESTER ROAD","Bronx","2102995","10469","212","14","0","14","3","4.7"
"726 GARDEN STREET","Bronx","2103143","10457","206","12","0","12","3","4"
"2936 GRACE AVENUE","Bronx","2103148","10469","212","16","0","16","3","5.3"
"1146 HAVEMEYER AVENUE","Bronx","2103456","10462","209","11","0","11","3","3.7"
"3055 OLINVILLE AVENUE","Bronx","2103643","10467","212","26","0","26","8","3.3"
"643 THIERIOT AVENUE","Bronx","2103878","10473","209","58","0","58","3","19.3"
"674 EAST  222 STREET","Bronx","2109528","10467","212","24","0","24","3","8"
"2159 BELMONT AVENUE","Bronx","2109538","10457","206","14","0","14","3","4.7"
"2546 COLDEN AVENUE","Bronx","2109545","10469","211","21","0","21","6","3.5"
"821 EAST  228 STREET","Bronx","2109554","10466","212","11","0","11","3","3.7"
"2315 BARNES AVENUE","Bronx","2111008","10467","211","184","0","184","28","6.6"
"745 EAST  216 STREET","Bronx","2111356","10467","212","12","0","12","4","3"
"412 EAST  187 STREET","Bronx","2112732","10458","206","22","0","22","3","7.3"
"1980 MARMION AVENUE","Bronx","2112747","10460","206","31","0","31","4","7.8"
"1984 MARMION AVENUE","Bronx","2112748","10460","206","16","0","16","4","4"
"1986 MARMION AVENUE","Bronx","2112749","10460","206","57","0","57","4","14.3"
"766 UNION AVENUE","Bronx","2112814","10455","201","46","0","46","8","5.8"
"187 ST GEORGE'S CRESCENT","Bronx","2112841","10458","207","34","0","34","8","4.3"
"189 ST GEORGE'S CRESCENT","Bronx","2112842","10458","207","33","6","39","8","4.9"
"276 EAST  166 STREET","Bronx","2113002","10456","204","13","0","13","3","4.3"
"163 WEST  161 STREET","Bronx","2113004","10452","204","92","0","92","4","23"
"167 WEST  161 STREET","Bronx","2113006","10452","204","14","0","14","4","3.5"
"644B MANIDA STREET","Bronx","2113025","10474","202","50","0","50","3","16.7"
"600 CONCORD AVENUE","Bronx","2113113","10455","201","235","0","235","83","2.8"
"1500 VYSE AVENUE","Bronx","2113153","10460","203","13","0","13","3","4.3"
"2541A GRAND AVENUE","Bronx","2113173","10468","207","28","5","33","3","11"
"2187 ENGLAND THRUWAY SR","Bronx","2113221","10475","212","10","0","10","3","3.3"
"1358 DR M L KING JR BOULEVARD","Bronx","2113261","10452","204","21","0","21","3","7"
"502 EAST  184 STREET","Bronx","2113321","10458","206","30","0","30","3","10"
"772 EAST  168 STREET","Bronx","2113382","10456","203","318","2","320","60","5.3"
"592 EAST  178 STREET","Bronx","2113412","10457","206","30","0","30","3","10"
"852 EAST  221 STREET","Bronx","2113450","10467","212","28","0","28","3","9.3"
"854 EAST  221 STREET","Bronx","2113451","10467","212","24","0","24","3","8"
"1356 LYMAN PLACE","Bronx","2113557","10459","203","32","0","32","3","10.7"
"3218 COLDEN AVENUE","Bronx","2113657","10469","212","12","0","12","3","4"
"724 EAST  217 STREET","Bronx","2113663","10467","212","36","0","36","8","4.5"
"182 WEST  168 STREET","Bronx","2113770","10452","204","74","0","74","3","24.7"
"2016 HONEYWELL AVENUE","Bronx","2113798","10460","206","7","3","10","3","3.3"
"163 WEST  195 STREET","Bronx","2113803","10468","208","13","0","13","3","4.3"
"1002 COLLEGE AVENUE","Bronx","2113922","10456","204","6","4","10","3","3.3"
"2051 HERMANY AVENUE","Bronx","2113970","10473","209","22","0","22","3","7.3"
"1825 PILGRIM AVENUE","Bronx","2113979","10461","210","36","0","36","3","12"
"728 EAST  221 STREET","Bronx","2114034","10467","212","78","0","78","8","9.8"
"827 EAST  222 STREET","Bronx","2114043","10467","212","11","0","11","3","3.7"
"721 EAST  216 STREET","Bronx","2114049","10467","212","10","1","11","3","3.7"
"1002 BOYNTON AVENUE","Bronx","2114067","10472","209","10","0","10","3","3.3"
"1007 WARD AVENUE","Bronx","2114071","10472","209","14","0","14","3","4.7"
"1520 BRUCKNER BOULEVARD","Bronx","2114120","10473","209","49","1","50","8","6.3"
"1210 COLLEGE AVENUE","Bronx","2114159","10456","204","12","1","13","3","4.3"
"983 BOSTON ROAD","Bronx","2114178","10456","203","24","0","24","3","8"
"875 CAULDWELL AVENUE","Bronx","2114195","10456","203","22","0","22","3","7.3"
"1176 FOREST AVENUE","Bronx","2114200","10456","203","55","0","55","8","6.9"
"934 EAST  165 STREET","Bronx","2114216","10459","202","36","0","36","3","12"
"1313 SENECA AVENUE","Bronx","2114219","10474","202","31","0","31","3","10.3"
"800 FREEMAN STREET","Bronx","2114244","10459","203","19","0","19","3","6.3"
"1372 PROSPECT AVENUE","Bronx","2114245","10459","203","2","21","23","3","7.7"
"689 EAST  219 STREET","Bronx","2114368","10467","212","16","0","16","3","5.3"
"869 EAST  217 STREET","Bronx","2114372","10467","212","50","0","50","8","6.3"
"2827 SEDGWICK AVENUE","Bronx","2114503","10468","208","0","9","9","3","3"
"1164 UNION AVENUE","Bronx","2114548","10459","203","28","0","28","3","9.3"
"839 FREEMAN STREET","Bronx","2114652","10459","203","13","0","13","3","4.3"
"2333 PROSPECT AVENUE","Bronx","2114653","10458","206","111","2","113","33","3.4"
"716 PUGSLEY AVENUE","Bronx","2114747","10473","209","25","0","25","3","8.3"
"1550 PARKER STREET","Bronx","2114761","10462","210","51","0","51","8","6.4"
"1426 VYSE AVENUE","Bronx","2114762","10459","203","17","4","21","3","7"
"3605 WILLETT AVENUE","Bronx","2114767","10467","212","16","0","16","3","5.3"
"754 EAST  214 STREET","Bronx","2114782","10467","212","31","0","31","3","10.3"
"270 EAST BURNSIDE AVENUE","Bronx","2114883","10457","205","272","1","273","114","2.4"
"3713 PAULDING AVENUE","Bronx","2114901","10469","212","13","0","13","3","4.3"
"814 BRYANT AVENUE","Bronx","2114922","10474","202","24","0","24","3","8"
"838 BRYANT AVENUE","Bronx","2114931","10474","202","13","0","13","3","4.3"
"793 JENNINGS STREET","Bronx","2114932","10459","203","27","0","27","3","9"
"785 JENNINGS STREET","Bronx","2114940","10459","203","79","0","79","3","26.3"
"661 EAST  234 STREET","Bronx","2114942","10466","212","17","0","17","3","5.7"
"1739 MANSION STREET","Bronx","2114959","10460","209","7","2","9","3","3"
"443 EAST  186 STREET","Bronx","2114972","10458","206","311","1","312","70","4.5"
"658 EAST  232 STREET","Bronx","2114991","10466","212","12","0","12","3","4"
"1053 SUMMIT AVENUE","Bronx","2115018","10452","204","16","0","16","3","5.3"
"1051 SUMMIT AVENUE","Bronx","2115019","10452","204","26","2","28","3","9.3"
"1049 SUMMIT AVENUE","Bronx","2115020","10452","204","14","0","14","3","4.7"
"1047 SUMMIT AVENUE","Bronx","2115021","10452","204","27","0","27","3","9"
"879 ELSMERE PLACE","Bronx","2115027","10460","206","10","0","10","3","3.3"
"678 EAST  221 STREET","Bronx","2115154","10467","212","31","0","31","3","10.3"
"1009 ELDER AVENUE","Bronx","2115181","10472","209","10","0","10","3","3.3"
"1453 KNAPP STREET","Bronx","2115248","10469","212","25","0","25","3","8.3"
"1321A COLLEGE AVENUE","Bronx","2115295","10456","204","24","0","24","3","8"
"1337 LELAND AVENUE","Bronx","2115324","10472","209","9","0","9","3","3"
"3939 DE REIMER AVENUE","Bronx","2115357","10466","212","11","0","11","3","3.7"
"3410 WRIGHT AVENUE","Bronx","2115538","10475","212","23","0","23","3","7.7"
"4501 BRONX BOULEVARD","Bronx","2115547","10470","212","7","11","18","3","6"
"3561 BRONXWOOD AVENUE","Bronx","2115564","10469","212","11","0","11","3","3.7"
"648 CONCORD AVENUE","Bronx","2115685","10455","201","28","0","28","3","9.3"
"1411 BRYANT AVENUE","Bronx","2115738","10459","203","15","0","15","3","5"
"1987 CRUGER AVENUE","Bronx","2115778","10462","211","9","0","9","3","3"
"724 UNION AVENUE","Bronx","2115862","10455","201","53","0","53","3","17.7"
"862 EAST  175 STREET","Bronx","2115905","10460","206","24","0","24","3","8"
"871 EAST  179 STREET","Bronx","2115990","10460","206","166","7","173","40","4.3"
"2546A WHITE PLAINS ROAD","Bronx","2116147","10467","211","34","0","34","6","5.7"
"2544A WHITE PLAINS ROAD","Bronx","2116148","10467","211","23","0","23","6","3.8"
"2542 WHITE PLAINS ROAD","Bronx","2116150","10467","211","57","0","57","6","9.5"
"311 EAST  163 STREET","Bronx","2116215","10451","204","46","0","46","3","15.3"
"1864 GUERLAIN STREET","Bronx","2116250","10460","209","35","1","36","3","12"
"2405 BARKER AVENUE","Bronx","2116281","10467","211","9","0","9","3","3"
"800 EAST  215 STREET","Bronx","2116288","10467","212","34","2","36","3","12"
"806 EAST  216 STREET","Bronx","2116292","10467","212","47","0","47","3","15.7"
"4442 RICHARDSON AVENUE","Bronx","2116306","10470","212","12","0","12","3","4"
"1499 GRAND CONCOURSE","Bronx","2116449","10452","204","67","0","67","18","3.7"
"202 KEARNEY AVENUE","Bronx","2116492","10465","210","11","0","11","3","3.7"
"1743 DAVIDSON AVENUE","Bronx","2116564","10453","205","28","0","28","3","9.3"
"1739 DAVIDSON AVENUE","Bronx","2116566","10453","205","8","1","9","3","3"
"2600 GRAND AVENUE","Bronx","2116594","10468","207","9","0","9","3","3"
"1221 MORRISON AVENUE","Bronx","2116880","10472","209","21","0","21","3","7"
"3436 CORSA AVENUE","Bronx","2116996","10469","212","32","0","32","10","3.2"
"3452 CORSA AVENUE","Bronx","2117002","10469","212","46","0","46","14","3.3"
"3486 CORSA AVENUE","Bronx","2117008","10469","212","48","0","48","10","4.8"
"3467 EASTCHESTER ROAD","Bronx","2117012","10469","212","182","0","182","38","4.8"
"3485 EASTCHESTER ROAD","Bronx","2117013","10469","212","30","0","30","10","3"
"3486 FENTON AVENUE","Bronx","2117022","10469","212","40","0","40","10","4"
"3437 CORSA AVENUE","Bronx","2117023","10469","212","40","0","40","10","4"
"3469 CORSA AVENUE","Bronx","2117029","10469","212","32","0","32","9","3.6"
"3481 FENTON AVENUE","Bronx","2117033","10469","212","33","0","33","10","3.3"
"3463 SEYMOUR AVENUE","Bronx","2117065","10469","212","30","0","30","9","3.3"
"3439 FISH AVENUE","Bronx","2117074","10469","212","57","0","57","18","3.2"
"3455 FISH AVENUE","Bronx","2117078","10469","212","37","0","37","10","3.7"
"1680 BRUCKNER BOULEVARD","Bronx","2117186","10473","209","28","0","28","8","3.5"
"1685 BANYER PLACE","Bronx","2117187","10473","209","37","0","37","9","4.1"
"2116 BOGART AVENUE","Bronx","2117268","10462","211","10","0","10","3","3.3"
"712 EAST  214 STREET","Bronx","2117623","10467","212","30","0","30","9","3.3"
"2307 CROTONA AVENUE","Bronx","2118364","10458","206","19","0","19","5","3.8"
"850 HOME STREET","Bronx","2118373","10459","202","12","1","13","3","4.3"
"755 EAST  214 STREET","Bronx","2118395","10467","212","33","0","33","10","3.3"
"2913B CRUGER AVENUE","Bronx","2118523","10467","211","32","0","32","4","8"
"1646 ANDREWS AVENUE SOUTH","Bronx","2119005","10453","205","13","0","13","3","4.3"
"1778 SOUTHERN BOULEVARD","Bronx","2119434","10460","203","125","10","135","64","2.1"
"1189 GRANT AVENUE","Bronx","2120179","10456","204","15","1","16","3","5.3"
"1210 HOE AVENUE","Bronx","2120531","10459","203","13","0","13","3","4.3"
"742 EAST  222 STREET","Bronx","2121263","10467","212","34","0","34","8","4.3"
"931 EAST  216 STREET","Bronx","2121356","10469","212","26","0","26","3","8.7"
"3810 BARNES AVENUE","Bronx","2121568","10467","212","9","0","9","3","3"
"1052 EAST  223 STREET","Bronx","2122274","10466","212","11","0","11","3","3.7"
"424 LELAND AVENUE","Bronx","2123697","10473","209","29","0","29","3","9.7"
"428 LELAND AVENUE","Bronx","2123699","10473","209","14","0","14","3","4.7"
"937 SUMMIT AVENUE","Bronx","2124405","10452","204","34","0","34","8","4.3"
"933 SUMMIT AVENUE","Bronx","2124483","10452","204","38","0","38","8","4.8"
"1972 BATHGATE AVENUE","Bronx","2124485","10457","206","26","0","26","3","8.7"
"2296 BELMONT AVENUE","Bronx","2124785","10457","206","14","0","14","3","4.7"
"989 OGDEN AVENUE","Bronx","2127046","10452","204","71","1","72","14","5.1"
"2120 DALY AVENUE","Bronx","2127282","10460","206","66","0","66","21","3.1"
"764 EAST  152 STREET","Bronx","2127436","10455","201","73","1","74","24","3.1"
"499 EAST  188 STREET","Bronx","2127594","10458","206","179","1","180","40","4.5"
"2305 CROTONA AVENUE","Bronx","2127644","10458","206","35","0","35","5","7"
"716 EAST  234 STREET","Bronx","2128060","10466","212","74","0","74","9","8.2"
"1417 LONGFELLOW AVENUE","Bronx","2128697","10459","203","110","2","112","38","2.9"
"819 EAST  218 STREET","Bronx","2129411","10467","212","12","0","12","4","3"
"191 SCHERMERHORN STREET","Brooklyn","3000493","11201","302","40","0","40","7","5.7"
"284 ATLANTIC AVENUE","Brooklyn","3000822","11201","302","28","1","29","7","4.1"
"255 PACIFIC STREET","Brooklyn","3000828","11201","302","62","7","69","14","4.9"
"304 ATLANTIC AVENUE","Brooklyn","3000835","11201","302","26","0","26","6","4.3"
"334 ATLANTIC AVENUE","Brooklyn","3000845","11201","302","42","0","42","14","3"
"483 PACIFIC STREET","Brooklyn","3000988","11217","302","29","5","34","8","4.3"
"247 BERGEN STREET","Brooklyn","3001420","11217","302","43","1","44","4","11"
"76 HENRY STREET","Brooklyn","3001698","11201","302","10","0","10","3","3.3"
"128 MONTAGUE STREET","Brooklyn","3002077","11201","302","28","5","33","8","4.1"
"152 MONTAGUE STREET","Brooklyn","3002087","11201","302","28","0","28","9","3.1"
"95 COURT STREET","Brooklyn","3002646","11201","302","38","1","39","4","9.8"
"172 ATLANTIC AVENUE","Brooklyn","3002977","11201","306","10","0","10","3","3.3"
"360 HENRY STREET","Brooklyn","3003103","11201","306","0","17","17","3","5.7"
"151 BALTIC STREET","Brooklyn","3003315","11201","306","39","0","39","9","4.3"
"404 HENRY STREET","Brooklyn","3003469","11201","306","8","7","15","4","3.8"
"165 COLUMBIA STREET","Brooklyn","3003565","11231","306","43","0","43","3","14.3"
"126 KANE STREET","Brooklyn","3003705","11231","306","30","0","30","4","7.5"
"13 STRONG PLACE","Brooklyn","3003896","11231","306","95","1","96","16","6"
"213 SACKETT STREET","Brooklyn","3004178","11231","306","36","0","36","8","4.5"
"115 VAN BRUNT STREET","Brooklyn","3004369","11231","306","18","0","18","6","3"
"522A HENRY STREET","Brooklyn","3004486","11231","306","13","0","13","4","3.3"
"420 CLINTON STREET","Brooklyn","3004772","11231","306","25","1","26","6","4.3"
"74 1 PLACE","Brooklyn","3005145","11231","306","49","0","49","5","9.8"
"64 BERGEN STREET","Brooklyn","3005740","11201","302","14","0","14","3","4.7"
"320 BERGEN STREET","Brooklyn","3005985","11217","302","12","0","12","3","4"
"21 ST MARKS PLACE","Brooklyn","3006022","11217","302","10","0","10","3","3.3"
"178 NEVINS STREET","Brooklyn","3006225","11217","302","38","0","38","8","4.8"
"372 BALTIC STREET","Brooklyn","3006430","11201","306","55","0","55","8","6.9"
"83 BUTLER STREET","Brooklyn","3006447","11231","306","34","0","34","8","4.3"
"213 BUTLER STREET","Brooklyn","3006463","11217","306","12","1","13","3","4.3"
"160 4 AVENUE","Brooklyn","3006627","11217","306","42","0","42","8","5.3"
"361 DE GRAW STREET","Brooklyn","3006750","11231","306","11","0","11","3","3.7"
"284 SMITH STREET","Brooklyn","3007027","11231","306","10","6","16","3","5.3"
"361 COURT STREET","Brooklyn","3007215","11231","306","128","9","137","9","15.2"
"357 COURT STREET","Brooklyn","3007217","11231","306","158","0","158","4","39.5"
"105 3 PLACE","Brooklyn","3007956","11231","306","31","1","32","8","4"
"60 NELSON STREET","Brooklyn","3008346","11231","306","19","0","19","6","3.2"
"68 NELSON STREET","Brooklyn","3008350","11231","306","27","0","27","8","3.4"
"70 NELSON STREET","Brooklyn","3008351","11231","306","50","1","51","8","6.4"
"433 COLUMBIA STREET","Brooklyn","3008427","11231","306","19","0","19","4","4.8"
"151 CONOVER STREET","Brooklyn","3008580","11231","306","208","5","213","36","5.9"
"164 DIKEMAN STREET","Brooklyn","3008593","11231","306","51","0","51","8","6.4"
"416 VAN BRUNT STREET","Brooklyn","3008798","11231","306","38","0","38","7","5.4"
"162 BEARD STREET","Brooklyn","3008852","11231","306","17","0","17","3","5.7"
"166 17 STREET","Brooklyn","3008945","11215","307","61","6","67","3","22.3"
"229 23 STREET","Brooklyn","3009465","11232","307","38","3","41","8","5.1"
"227 23 STREET","Brooklyn","3009466","11232","307","108","0","108","8","13.5"
"225 23 STREET","Brooklyn","3009467","11232","307","55","0","55","8","6.9"
"773 4 AVENUE","Brooklyn","3009674","11232","307","42","0","42","8","5.3"
"140 29 STREET","Brooklyn","3009837","11232","307","42","0","42","8","5.3"
"194 29 STREET","Brooklyn","3009852","11232","307","11","0","11","3","3.7"
"124 32 STREET","Brooklyn","3010077","11232","307","19","0","19","3","6.3"
"126 32 STREET","Brooklyn","3010078","11232","307","56","0","56","5","11.2"
"122 33 STREET","Brooklyn","3010143","11232","307","39","0","39","6","6.5"
"128 33 STREET","Brooklyn","3010145","11232","307","20","1","21","6","3.5"
"159 34 STREET","Brooklyn","3010164","11232","307","14","0","14","3","4.7"
"206 33 STREET","Brooklyn","3010190","11232","307","14","0","14","3","4.7"
"3914 3 AVENUE","Brooklyn","3010464","11232","307","27","0","27","6","4.5"
"3914 4 AVENUE","Brooklyn","3010493","11232","307","29","0","29","8","3.6"
"471 40 STREET","Brooklyn","3010545","11232","307","22","0","22","6","3.7"
"456 40 STREET","Brooklyn","3010594","11232","307","79","0","79","6","13.2"
"468 40 STREET","Brooklyn","3010597","11232","307","25","0","25","6","4.2"
"451 41 STREET","Brooklyn","3010612","11232","307","13","0","13","3","4.3"
"4112 4 AVENUE","Brooklyn","3010690","11232","307","195","1","196","57","3.4"
"460 41 STREET","Brooklyn","3010741","11232","307","59","1","60","16","3.8"
"4228 5 AVENUE","Brooklyn","3010863","11232","307","30","0","30","7","4.3"
"4324 8 AVENUE","Brooklyn","3011031","11232","307","20","0","20","6","3.3"
"4420 3 AVENUE","Brooklyn","3011094","11220","307","87","3","90","7","12.9"
"229 45 STREET","Brooklyn","3011115","11220","307","19","0","19","3","6.3"
"4417 5 AVENUE","Brooklyn","3011241","11220","307","22","0","22","6","3.7"
"4520 6 AVENUE","Brooklyn","3011626","11220","307","0","9","9","3","3"
"4606 5 AVENUE","Brooklyn","3011855","11220","307","25","0","25","8","3.1"
"601 47 STREET","Brooklyn","3011953","11220","307","96","0","96","10","9.6"
"668 46 STREET","Brooklyn","3011987","11220","307","20","2","22","6","3.7"
"4711 5 AVENUE","Brooklyn","3012273","11220","307","61","0","61","12","5.1"
"832 47 STREET","Brooklyn","3012475","11220","312","18","0","18","3","6"
"838 47 STREET","Brooklyn","3012477","11220","312","19","0","19","4","4.8"
"871 48 STREET","Brooklyn","3012492","11220","312","241","5","246","32","7.7"
"4803 5 AVENUE","Brooklyn","3012638","11220","307","9","0","9","3","3"
"565 49 STREET","Brooklyn","3012675","11220","307","52","0","52","8","6.5"
"4806 7 AVENUE","Brooklyn","3012725","11220","307","15","0","15","5","3"
"677 49 STREET","Brooklyn","3012731","11220","307","56","0","56","10","5.6"
"721 49 STREET","Brooklyn","3012796","11220","307","27","0","27","4","6.8"
"4905 4 AVENUE","Brooklyn","3012912","11220","307","23","0","23","6","3.8"
"426 49 STREET","Brooklyn","3012917","11220","307","38","0","38","8","4.8"
"434 49 STREET","Brooklyn","3012919","11220","307","47","0","47","8","5.9"
"565 50 STREET","Brooklyn","3012991","11220","307","24","0","24","6","4"
"559 50 STREET","Brooklyn","3012993","11220","307","23","0","23","6","3.8"
"5013 4 AVENUE","Brooklyn","3013238","11220","307","26","0","26","8","3.3"
"402 50 STREET","Brooklyn","3013242","11220","307","24","0","24","6","4"
"465 51 STREET","Brooklyn","3013278","11220","307","37","0","37","3","12.3"
"549 51 STREET","Brooklyn","3013325","11220","307","60","0","60","9","6.7"
"236 51 STREET","Brooklyn","3013469","11220","307","32","0","32","6","5.3"
"242 51 STREET","Brooklyn","3013472","11220","307","33","0","33","6","5.5"
"5114 4 AVENUE","Brooklyn","3013508","11220","307","47","0","47","5","9.4"
"444 51 STREET","Brooklyn","3013548","11220","307","23","1","24","8","3"
"463 52 STREET","Brooklyn","3013571","11220","307","96","5","101","6","16.8"
"513 52 STREET","Brooklyn","3013649","11220","307","14","0","14","3","4.7"
"460 52 STREET","Brooklyn","3013909","11220","307","21","0","21","7","3"
"746 52 STREET","Brooklyn","3014086","11220","307","19","0","19","3","6.3"
"735 53 STREET","Brooklyn","3014123","11220","307","26","0","26","6","4.3"
"230 53 STREET","Brooklyn","3014145","11220","307","28","0","28","6","4.7"
"5301 5 AVENUE","Brooklyn","3014290","11220","307","24","0","24","6","4"
"517 54 STREET","Brooklyn","3014339","11220","307","18","0","18","4","4.5"
"232 54 STREET","Brooklyn","3014489","11220","307","28","1","29","6","4.8"
"234 54 STREET","Brooklyn","3014490","11220","307","25","0","25","6","4.2"
"749 55 STREET","Brooklyn","3014836","11220","307","30","0","30","6","5"
"715 55 STREET","Brooklyn","3014849","11220","307","77","2","79","6","13.2"
"256 55 STREET","Brooklyn","3014864","11220","307","19","0","19","5","3.8"
"5513 4 AVENUE","Brooklyn","3014936","11220","307","81","0","81","6","13.5"
"637 56 STREET","Brooklyn","3015115","11220","307","20","0","20","6","3.3"
"617 56 STREET","Brooklyn","3015122","11220","307","25","0","25","6","4.2"
"5511 7 AVENUE","Brooklyn","3015129","11220","307","24","0","24","6","4"
"5614 6 AVENUE","Brooklyn","3015403","11220","307","48","2","50","9","5.6"
"5605 6 AVENUE","Brooklyn","3015438","11220","307","28","0","28","6","4.7"
"642 56 STREET","Brooklyn","3015451","11220","307","15","0","15","3","5"
"365 58 STREET","Brooklyn","3015630","11220","307","44","0","44","8","5.5"
"5701 4 AVENUE","Brooklyn","3015654","11220","307","31","0","31","4","7.8"
"412 57 STREET","Brooklyn","3015655","11220","307","13","0","13","3","4.3"
"442 57 STREET","Brooklyn","3015668","11220","307","9","0","9","3","3"
"5707 6 AVENUE","Brooklyn","3015785","11220","307","9","0","9","3","3"
"610 57 STREET","Brooklyn","3015789","11220","307","14","0","14","3","4.7"
"328 58 STREET","Brooklyn","3015923","11220","307","34","0","34","8","4.3"
"364 58 STREET","Brooklyn","3015938","11220","307","57","1","58","15","3.9"
"5807 5 AVENUE","Brooklyn","3016044","11220","307","29","0","29","8","3.6"
"5803 5 AVENUE","Brooklyn","3016045","11220","307","54","0","54","6","9"
"5801 5 AVENUE","Brooklyn","3016046","11220","307","58","0","58","7","8.3"
"529 59 STREET","Brooklyn","3016099","11220","307","9","0","9","3","3"
"263 60 STREET","Brooklyn","3016241","11220","307","51","0","51","6","8.5"
"245 60 STREET","Brooklyn","3016249","11220","307","108","0","108","6","18"
"740 59 STREET","Brooklyn","3016406","11220","307","42","8","50","6","8.3"
"349 17 STREET","Brooklyn","3016508","11215","307","82","3","85","6","14.2"
"266 PROSPECT PARK WEST","Brooklyn","3016584","11215","307","28","0","28","6","4.7"
"270 PROSPECT PARK WEST","Brooklyn","3016586","11215","307","22","0","22","7","3.1"
"272 PROSPECT PARK WEST","Brooklyn","3016587","11215","307","37","0","37","6","6.2"
"455 17 STREET","Brooklyn","3016602","11215","307","14","0","14","3","4.7"
"259 PROSPECT PARK WEST","Brooklyn","3016612","11215","307","34","0","34","7","4.9"
"510 17 STREET","Brooklyn","3016947","11215","307","5","7","12","3","4"
"273 20 STREET","Brooklyn","3017171","11215","307","39","0","39","8","4.9"
"564 7 AVENUE","Brooklyn","3017222","11215","307","15","10","25","8","3.1"
"1918 8 AVENUE","Brooklyn","3017276","11215","307","33","2","35","6","5.8"
"349 21 STREET","Brooklyn","3017461","11215","307","0","34","34","6","5.7"
"532 39 STREET","Brooklyn","3017800","11232","307","32","1","33","6","5.5"
"566 39 STREET","Brooklyn","3017807","11232","307","71","2","73","6","12.2"
"527 40 STREET","Brooklyn","3017836","11232","307","39","0","39","8","4.9"
"4002 8 AVENUE","Brooklyn","3018078","11232","307","31","0","31","5","6.2"
"735 41 STREET","Brooklyn","3018095","11232","307","64","4","68","6","11.3"
"838 40 STREET","Brooklyn","3018121","11232","312","23","0","23","4","5.8"
"4109 7 AVENUE","Brooklyn","3018164","11232","307","70","0","70","16","4.4"
"4103 7 AVENUE","Brooklyn","3018165","11232","307","59","2","61","20","3"
"869 42 STREET","Brooklyn","3018243","11232","312","76","0","76","16","4.8"
"4222 8 AVENUE","Brooklyn","3018301","11232","307","15","0","15","4","3.8"
"53 5 AVENUE","Brooklyn","3018581","11217","306","41","1","42","6","7"
"74 5 AVENUE","Brooklyn","3018665","11217","306","45","3","48","6","8"
"661 BALTIC STREET","Brooklyn","3018824","11217","306","29","0","29","6","4.8"
"28 7 AVENUE","Brooklyn","3019284","11217","306","0","15","15","4","3.8"
"660 DE GRAW STREET","Brooklyn","3019529","11217","306","13","0","13","4","3.3"
"713 SACKETT STREET","Brooklyn","3019568","11217","306","58","0","58","8","7.3"
"690 SACKETT STREET","Brooklyn","3019691","11217","306","26","0","26","4","6.5"
"126 BERKELEY PLACE","Brooklyn","3019855","11217","306","111","0","111","4","27.8"
"232 5 AVENUE","Brooklyn","3020250","11215","306","16","0","16","3","5.3"
"203 GARFIELD PLACE","Brooklyn","3020547","11215","306","20","1","21","5","4.2"
"294 5 AVENUE","Brooklyn","3020778","11215","306","48","0","48","7","6.9"
"317 4 AVENUE","Brooklyn","3020888","11215","306","38","0","38","8","4.8"
"315 4 AVENUE","Brooklyn","3020889","11215","306","138","1","139","6","23.2"
"369 5 AVENUE","Brooklyn","3021385","11215","306","31","1","32","6","5.3"
"365 5 AVENUE","Brooklyn","3021387","11215","306","18","0","18","6","3"
"242 6 STREET","Brooklyn","3021558","11215","306","53","0","53","8","6.6"
"400 5 AVENUE","Brooklyn","3021606","11215","306","20","1","21","3","7"
"401 5 AVENUE","Brooklyn","3021631","11215","306","9","0","9","3","3"
"416 4 AVENUE","Brooklyn","3021808","11215","306","8","10","18","6","3"
"130 9 STREET","Brooklyn","3022205","11215","306","26","0","26","8","3.3"
"331 13 STREET","Brooklyn","3023251","11215","306","31","0","31","9","3.4"
"520 4 AVENUE","Brooklyn","3023362","11215","306","149","0","149","8","18.6"
"522 4 AVENUE","Brooklyn","3023363","11215","306","65","0","65","8","8.1"
"526 4 AVENUE","Brooklyn","3023365","11215","306","58","8","66","7","9.4"
"60 15 STREET","Brooklyn","3023819","11215","307","15","0","15","3","5"
"62 15 STREET","Brooklyn","3023820","11215","307","34","0","34","3","11.3"
"187 16 STREET","Brooklyn","3023929","11215","307","9","9","18","6","3"
"270 15 STREET","Brooklyn","3023966","11215","307","202","1","203","20","10.2"
"76 16 STREET","Brooklyn","3024067","11215","307","81","0","81","8","10.1"
"199 PROSPECT AVENUE","Brooklyn","3024163","11215","307","85","0","85","6","14.2"
"582 6 AVENUE","Brooklyn","3024206","11215","307","18","1","19","6","3.2"
"507 8 AVENUE","Brooklyn","3025617","11215","306","15","0","15","5","3"
"317 7 AVENUE","Brooklyn","3025919","11215","306","29","2","31","6","5.2"
"807 8 AVENUE","Brooklyn","3025925","11215","306","31","0","31","8","3.9"
"920 8 AVENUE","Brooklyn","3026021","11215","306","36","6","42","4","10.5"
"673 10 STREET","Brooklyn","3026096","11215","306","19","0","19","4","4.8"
"505 11 STREET","Brooklyn","3026181","11215","306","15","0","15","3","5"
"1203 8 AVENUE","Brooklyn","3026404","11215","306","65","2","67","8","8.4"
"899 PACIFIC STREET","Brooklyn","3027478","11238","308","12","0","12","4","3"
"552 DEAN STREET","Brooklyn","3027816","11217","308","151","3","154","8","19.3"
"545 BERGEN STREET","Brooklyn","3027832","11217","308","27","1","28","8","3.5"
"580 VANDERBILT AVENUE","Brooklyn","3028143","11238","308","13","0","13","4","3.3"
"197 ST MARKS AVENUE","Brooklyn","3028153","11238","308","19","0","19","6","3.2"
"621 VANDERBILT AVENUE","Brooklyn","3028189","11238","308","39","0","39","4","9.8"
"740 BERGEN STREET","Brooklyn","3028224","11238","308","11","0","11","3","3.7"
"689 CLASSON AVENUE","Brooklyn","3028284","11238","308","77","1","78","23","3.4"
"667 CLASSON AVENUE","Brooklyn","3028291","11238","308","19","2","21","6","3.5"
"872 BERGEN STREET","Brooklyn","3028293","11238","308","48","0","48","8","6"
"459 ST MARKS AVENUE","Brooklyn","3028328","11238","308","39","1","40","5","8"
"94 ST MARKS AVENUE","Brooklyn","3028341","11217","308","16","1","17","3","5.7"
"340 ST MARKS AVENUE","Brooklyn","3028555","11238","308","64","0","64","6","10.7"
"345 PROSPECT PLACE","Brooklyn","3028576","11238","308","38","0","38","8","4.8"
"618 GRAND AVENUE","Brooklyn","3028593","11238","308","30","0","30","8","3.8"
"388 ST MARKS AVENUE","Brooklyn","3028609","11238","308","88","0","88","12","7.3"
"400 ST MARKS AVENUE","Brooklyn","3028612","11238","308","39","0","39","12","3.3"
"408 ST MARKS AVENUE","Brooklyn","3028614","11238","308","28","0","28","8","3.5"
"412 ST MARKS AVENUE","Brooklyn","3028616","11238","308","45","0","45","7","6.4"
"581 PROSPECT PLACE","Brooklyn","3028683","11238","308","12","0","12","4","3"
"175 PARK PLACE","Brooklyn","3028762","11238","308","77","0","77","10","7.7"
"386 PROSPECT PLACE","Brooklyn","3028876","11238","308","34","0","34","8","4.3"
"718 WASHINGTON AVENUE","Brooklyn","3028877","11238","308","36","0","36","4","9"
"395 PARK PLACE","Brooklyn","3028897","11238","308","15","0","15","4","3.8"
"572 PROSPECT PLACE","Brooklyn","3029003","11238","308","101","0","101","20","5"
"601 PARK PLACE","Brooklyn","3029023","11238","308","74","0","74","24","3.1"
"597 PARK PLACE","Brooklyn","3029024","11238","308","53","1","54","8","6.8"
"594 PARK PLACE","Brooklyn","3029269","11238","308","64","0","64","20","3.2"
"728 FRANKLIN AVENUE","Brooklyn","3029282","11238","308","38","0","38","12","3.2"
"403 ST JOHNS PLACE","Brooklyn","3029411","11238","308","112","0","112","27","4.1"
"567 ST JOHNS PLACE","Brooklyn","3029510","11238","308","307","1","308","8","38.5"
"392 ST JOHNS PLACE","Brooklyn","3029523","11238","308","109","2","111","39","2.8"
"832 WASHINGTON AVENUE","Brooklyn","3029542","11238","308","18","3","21","6","3.5"
"554 ST JOHNS PLACE","Brooklyn","3029582","11238","308","23","0","23","6","3.8"
"563 LINCOLN PLACE","Brooklyn","3029603","11238","308","25","10","35","6","5.8"
"842 CLASSON AVENUE","Brooklyn","3029647","11238","308","23","1","24","8","3"
"585 FRANKLIN AVENUE","Brooklyn","3029741","11238","308","10","0","10","3","3.3"
"579 FRANKLIN AVENUE","Brooklyn","3029744","11238","308","14","5","19","4","4.8"
"1355 PACIFIC STREET","Brooklyn","3029799","11216","308","27","0","27","8","3.4"
"1295 PACIFIC STREET","Brooklyn","3029816","11216","308","49","0","49","6","8.2"
"63 KINGSTON AVENUE","Brooklyn","3029904","11213","308","19","0","19","3","6.3"
"1075 DEAN STREET","Brooklyn","3029975","11216","308","32","1","33","3","11"
"1292 PACIFIC STREET","Brooklyn","3030046","11216","308","163","5","168","76","2.2"
"1237 DEAN STREET","Brooklyn","3030068","11216","308","49","5","54","13","4.2"
"1197 DEAN STREET","Brooklyn","3030088","11216","308","20","3","23","6","3.8"
"1332 PACIFIC STREET","Brooklyn","3030094","11216","308","14","0","14","3","4.7"
"1378 PACIFIC STREET","Brooklyn","3030111","11216","308","122","1","123","23","5.3"
"1448 PACIFIC STREET","Brooklyn","3030151","11216","308","43","0","43","8","5.4"
"95 KINGSTON AVENUE","Brooklyn","3030187","11213","308","27","0","27","8","3.4"
"126 ALBANY AVENUE","Brooklyn","3030211","11213","308","47","2","49","7","7"
"1077 BERGEN STREET","Brooklyn","3030337","11216","308","32","0","32","7","4.6"
"1071 BERGEN STREET","Brooklyn","3030340","11216","308","15","0","15","3","5"
"1055 BERGEN STREET","Brooklyn","3030348","11216","308","578","4","582","16","36.4"
"1051 BERGEN STREET","Brooklyn","3030349","11216","308","0","12","12","4","3"
"103 KINGSTON AVENUE","Brooklyn","3030514","11213","308","22","0","22","6","3.7"
"950 BERGEN STREET","Brooklyn","3030572","11216","308","37","1","38","10","3.8"
"952 BERGEN STREET","Brooklyn","3030573","11216","308","34","1","35","10","3.5"
"575 ST MARKS AVENUE","Brooklyn","3030616","11216","308","147","9","156","7","22.3"
"1066 BERGEN STREET","Brooklyn","3030657","11216","308","50","0","50","16","3.1"
"641 ST MARKS AVENUE","Brooklyn","3030690","11216","308","57","1","58","15","3.9"
"1144 BERGEN STREET","Brooklyn","3030724","11216","308","63","0","63","17","3.7"
"1292 BERGEN STREET","Brooklyn","3030770","11213","308","20","0","20","3","6.7"
"867 ST MARKS AVENUE","Brooklyn","3030793","11213","308","11","20","31","10","3.1"
"913 ST MARKS AVENUE","Brooklyn","3030802","11213","308","46","0","46","4","11.5"
"1338 BERGEN STREET","Brooklyn","3030822","11213","308","70","3","73","16","4.6"
"1340 BERGEN STREET","Brooklyn","3030823","11213","308","53","2","55","8","6.9"
"1342 BERGEN STREET","Brooklyn","3030824","11213","308","72","3","75","16","4.7"
"971 ST MARKS AVENUE","Brooklyn","3030844","11213","308","38","0","38","8","4.8"
"947 ST MARK'S AVENUE","Brooklyn","3030846","11213","308","51","0","51","13","3.9"
"1411 BEDFORD AVENUE","Brooklyn","3030918","11216","308","21","0","21","3","7"
"758 ST MARKS AVENUE","Brooklyn","3031002","11216","308","46","0","46","6","7.7"
"855 PROSPECT PLACE","Brooklyn","3031007","11216","308","49","0","49","7","7"
"805 PROSPECT PLACE","Brooklyn","3031024","11216","308","73","0","73","9","8.1"
"169 NEW YORK AVENUE","Brooklyn","3031027","11216","308","125","0","125","8","15.6"
"1097 PROSPECT PLACE","Brooklyn","3031088","11213","308","184","2","186","13","14.3"
"693 FRANKLIN AVENUE","Brooklyn","3031110","11238","308","40","0","40","8","5"
"1430 BEDFORD AVENUE","Brooklyn","3031131","11216","308","114","0","114","8","14.3"
"1434 BEDFORD AVENUE","Brooklyn","3031133","11216","308","74","0","74","8","9.3"
"725 PARK PLACE","Brooklyn","3031165","11216","308","36","0","36","8","4.5"
"101 ROGERS AVENUE","Brooklyn","3031192","11216","308","102","6","108","12","9"
"734 PROSPECT PLACE","Brooklyn","3031198","11216","308","10","3","13","3","4.3"
"746 PROSPECT PLACE","Brooklyn","3031204","11216","308","19","0","19","6","3.2"
"780 PROSPECT PLACE","Brooklyn","3031206","11216","308","57","1","58","8","7.3"
"815 PARK PLACE","Brooklyn","3031221","11216","308","45","0","45","8","5.6"
"846 PROSPECT PLACE","Brooklyn","3031239","11216","308","233","2","235","20","11.8"
"897 PARK PLACE","Brooklyn","3031258","11216","308","45","13","58","12","4.8"
"930 PROSPECT PLACE","Brooklyn","3031294","11213","308","217","1","218","16","13.6"
"940 PROSPECT PLACE","Brooklyn","3031295","11213","308","89","0","89","16","5.6"
"949 PARK PLACE","Brooklyn","3031305","11213","308","138","0","138","8","17.3"
"1452 BEDFORD AVENUE","Brooklyn","3031424","11216","308","35","1","36","8","4.5"
"1469 BEDFORD AVENUE","Brooklyn","3031457","11216","308","139","3","142","27","5.3"
"792 PARK PLACE","Brooklyn","3031497","11216","308","27","0","27","8","3.4"
"804 PARK PLACE","Brooklyn","3031501","11216","308","95","0","95","8","11.9"
"894 PARK PLACE","Brooklyn","3031548","11216","308","91","1","92","10","9.2"
"996 PARK PLACE","Brooklyn","3031639","11213","308","34","0","34","4","8.5"
"1069 STERLING PLACE","Brooklyn","3031673","11213","308","150","3","153","27","5.7"
"1478 BEDFORD AVENUE","Brooklyn","3031803","11216","308","20","1","21","6","3.5"
"1490 BEDFORD AVENUE","Brooklyn","3031806","11216","308","24","1","25","8","3.1"
"761 ST JOHN PLACE","Brooklyn","3031857","11216","308","15","1","16","4","4"
"811 ST JOHNS PLACE","Brooklyn","3031890","11216","308","42","0","42","6","7"
"248 NEW YORK AVENUE","Brooklyn","3031973","11216","308","119","0","119","8","14.9"
"250 NEW YORK AVENUE","Brooklyn","3031974","11216","308","59","0","59","8","7.4"
"254 NEW YORK AVENUE","Brooklyn","3031975","11216","308","31","0","31","8","3.9"
"239 KINGSTON AVENUE","Brooklyn","3032052","11213","308","20","0","20","5","4"
"268 ALBANY AVENUE","Brooklyn","3032076","11213","308","46","0","46","8","5.8"
"1157 ST JOHNS PLACE","Brooklyn","3032084","11213","308","19","0","19","4","4.8"
"1149 ST JOHNS PLACE","Brooklyn","3032087","11213","308","148","0","148","8","18.5"
"625 LINCOLN PLACE","Brooklyn","3032186","11216","308","13","0","13","4","3.3"
"689 LINCOLN PLACE","Brooklyn","3032206","11216","308","23","0","23","6","3.8"
"767 LINCOLN PLACE","Brooklyn","3032254","11216","308","101","0","101","12","8.4"
"521 EASTERN PARKWAY","Brooklyn","3032635","11216","308","18","2","20","3","6.7"
"755 EASTERN PARKWAY","Brooklyn","3032785","11213","308","26","0","26","6","4.3"
"805 EASTERN PARKWAY","Brooklyn","3032868","11213","308","26","0","26","3","8.7"
"807 NOSTRAND AVENUE","Brooklyn","3032925","11225","309","48","2","50","6","8.3"
"800 EASTERN PARKWAY","Brooklyn","3033060","11213","309","103","0","103","4","25.8"
"1027 PRESIDENT STREET","Brooklyn","3033146","11225","309","11","0","11","3","3.7"
"1171 PRESIDENT STREET","Brooklyn","3033219","11225","309","93","0","93","39","2.4"
"835 NOSTRAND AVENUE","Brooklyn","3033230","11225","309","137","6","143","10","14.3"
"823 NOSTRAND AVENUE","Brooklyn","3033234","11225","309","40","0","40","10","4"
"979 CARROLL STREET","Brooklyn","3033471","11225","309","235","4","239","69","3.5"
"1180 PRESIDENT STREET","Brooklyn","3033530","11225","309","338","0","338","20","16.9"
"1119 CARROLL STREET","Brooklyn","3033556","11225","309","26","1","27","8","3.4"
"1116 CARROLL STREET","Brooklyn","3033818","11225","309","121","1","122","43","2.8"
"384 MONTGOMERY STREET","Brooklyn","3034441","11225","309","131","1","132","43","3.1"
"392 ROGERS AVENUE","Brooklyn","3034764","11225","309","82","3","85","39","2.2"
"448 EMPIRE BOULEVARD","Brooklyn","3034846","11225","309","12","0","12","4","3"
"488 EMPIRE BOULEVARD","Brooklyn","3034858","11225","309","17","0","17","4","4.3"
"1789 BEDFORD AVENUE","Brooklyn","3034936","11225","309","24","0","24","6","4"
"1785 BEDFORD AVENUE","Brooklyn","3034937","11225","309","11","38","49","4","12.3"
"1783 BEDFORD AVENUE","Brooklyn","3034938","11225","309","9","3","12","4","3"
"446 KINGSTON AVENUE","Brooklyn","3035179","11225","309","478","4","482","194","2.5"
"197 LINCOLN ROAD","Brooklyn","3035257","11225","309","347","12","359","53","6.8"
"452 ROGERS AVENUE","Brooklyn","3035291","11225","309","50","0","50","7","7.1"
"437 ROGERS AVENUE","Brooklyn","3035330","11225","309","33","0","33","6","5.5"
"433 ROGERS AVENUE","Brooklyn","3035331","11225","309","61","0","61","12","5.1"
"429 ROGERS AVENUE","Brooklyn","3035332","11225","309","87","0","87","7","12.4"
"333 LINCOLN ROAD","Brooklyn","3035374","11225","309","26","1","27","8","3.4"
"495 EAST NEW YORK AVENUE","Brooklyn","3035457","11225","309","18","0","18","6","3"
"1638 ATLANTIC AVENUE","Brooklyn","3035510","11213","308","10","1","11","3","3.7"
"123 ALBANY AVENUE","Brooklyn","3035628","11213","308","64","1","65","6","10.8"
"1552 PACIFIC STREET","Brooklyn","3035639","11213","308","11","0","11","3","3.7"
"1596 PACIFIC STREET","Brooklyn","3035651","11213","308","35","0","35","8","4.4"
"78 TROY AVENUE","Brooklyn","3035654","11213","308","111","0","111","5","22.2"
"1505 DEAN STREET","Brooklyn","3035669","11213","308","19","0","19","3","6.3"
"374 RALPH AVENUE","Brooklyn","3035746","11233","308","78","0","78","13","6"
"135 ALBANY AVENUE","Brooklyn","3035758","11213","308","60","0","60","12","5"
"1605 BERGEN STREET","Brooklyn","3035829","11213","308","36","1","37","3","12.3"
"444 RALPH AVENUE","Brooklyn","3035972","11233","308","74","0","74","6","12.3"
"1160 ST MARKS AVENUE","Brooklyn","3036030","11213","308","38","0","38","4","9.5"
"1162 ST MARKS AVENUE","Brooklyn","3036031","11213","308","59","0","59","4","14.8"
"162 UTICA AVENUE","Brooklyn","3036047","11213","308","32","18","50","6","8.3"
"1341 PROSPECT PLACE","Brooklyn","3036061","11213","308","17","0","17","3","5.7"
"474 RALPH AVENUE","Brooklyn","3036139","11233","308","12","0","12","3","4"
"185 UTICA AVENUE","Brooklyn","3036275","11213","308","0","10","10","3","3.3"
"196 BUFFALO AVENUE","Brooklyn","3036312","11213","308","66","1","67","13","5.2"
"1557 PARK PLACE","Brooklyn","3036317","11213","308","45","2","47","4","11.8"
"193 BUFFALO AVENUE","Brooklyn","3036333","11213","308","37","0","37","10","3.7"
"1564 PROSPECT PLACE","Brooklyn","3036337","11233","308","27","0","27","6","4.5"
"1614 PROSPECT PLACE","Brooklyn","3036353","11233","308","15","0","15","4","3.8"
"1620 PROSPECT PLACE","Brooklyn","3036355","11233","308","73","2","75","4","18.8"
"1647 PARK PLACE","Brooklyn","3036360","11233","308","55","0","55","6","9.2"
"1641 PARK PLACE","Brooklyn","3036361","11233","308","40","0","40","6","6.7"
"1254 PARK PLACE","Brooklyn","3036413","11213","308","9","0","9","3","3"
"1353 STERLING PLACE","Brooklyn","3036450","11213","308","40","0","40","7","5.7"
"1350 PARK PLACE","Brooklyn","3036487","11213","308","341","1","342","19","18"
"1477 STERLING PLACE","Brooklyn","3036580","11213","308","12","0","12","3","4"
"213 BUFFALO AVENUE","Brooklyn","3036633","11213","308","20","0","20","6","3.3"
"536 RALPH AVENUE","Brooklyn","3036646","11233","308","28","0","28","5","5.6"
"1665 STERLING PLACE","Brooklyn","3036654","11233","308","17","0","17","4","4.3"
"1657 STERLING PLACE","Brooklyn","3036657","11233","308","12","0","12","4","3"
"239 TROY AVENUE","Brooklyn","3036730","11213","308","28","14","42","10","4.2"
"1288 STERLING PLACE","Brooklyn","3036738","11213","308","23","0","23","6","3.8"
"1294 STERLING PLACE","Brooklyn","3036740","11213","308","34","2","36","6","6"
"1298 STERLING PLACE","Brooklyn","3036741","11213","308","84","0","84","6","14"
"232 SCHENECTADY AVENUE","Brooklyn","3036759","11213","308","76","0","76","6","12.7"
"236 SCHENECTADY AVENUE","Brooklyn","3036761","11213","308","34","0","34","6","5.7"
"1333 ST JOHNS PLACE","Brooklyn","3036767","11213","308","35","0","35","6","5.8"
"1321 ST JOHNS PLACE","Brooklyn","3036771","11213","308","36","0","36","6","6"
"1392 STERLING PLACE","Brooklyn","3036804","11213","308","168","0","168","23","7.3"
"1402 STERLING PLACE","Brooklyn","3036805","11213","308","117","0","117","20","5.8"
"1408 STERLING PLACE","Brooklyn","3036806","11213","308","89","0","89","20","4.5"
"236 UTICA AVENUE","Brooklyn","3036826","11213","308","33","0","33","3","11"
"1391 ST JOHNS PLACE","Brooklyn","3036833","11213","308","28","0","28","8","3.5"
"1379 ST JOHNS PLACE","Brooklyn","3036839","11213","308","22","0","22","7","3.1"
"1448 STERLING PLACE","Brooklyn","3036855","11213","308","47","0","47","10","4.7"
"1460 STERLING PLACE","Brooklyn","3036857","11213","308","109","0","109","36","3"
"1507 ST JOHNS PLACE","Brooklyn","3036881","11213","308","66","0","66","21","3.1"
"1515 ST JOHNS PLACE","Brooklyn","3036903","11213","308","156","1","157","24","6.5"
"1668 STERLING PLACE","Brooklyn","3036919","11233","308","34","0","34","4","8.5"
"558 RALPH AVENUE","Brooklyn","3036927","11233","308","49","0","49","12","4.1"
"1631 ST JOHNS PLACE","Brooklyn","3036935","11233","308","33","0","33","9","3.7"
"1627 ST JOHNS PLACE","Brooklyn","3036937","11233","308","52","6","58","5","11.6"
"1623 ST JOHNS PLACE","Brooklyn","3036939","11233","308","18","0","18","4","4.5"
"1222 ST JOHNS PLACE","Brooklyn","3036956","11213","308","79","0","79","20","4"
"1324 ST JOHNS PLACE","Brooklyn","3037020","11213","308","70","0","70","8","8.8"
"1301 LINCOLN PLACE","Brooklyn","3037094","11213","308","25","0","25","8","3.1"
"1548 ST JOHNS PLACE","Brooklyn","3037164","11213","308","15","0","15","3","5"
"1491 LINCOLN PLACE","Brooklyn","3037195","11213","308","80","0","80","16","5"
"1561 LINCOLN PLACE","Brooklyn","3037239","11233","308","22","0","22","6","3.7"
"276 TROY AVENUE","Brooklyn","3037263","11213","308","16","0","16","3","5.3"
"1089 EASTERN PARKWAY","Brooklyn","3037336","11213","308","56","0","56","16","3.5"
"1187 EASTERN PARKWAY","Brooklyn","3037374","11213","308","109","7","116","16","7.3"
"1181 EASTERN PARKWAY","Brooklyn","3037375","11213","308","72","2","74","16","4.6"
"1610 LINCOLN PLACE","Brooklyn","3037434","11233","308","7","3","10","3","3.3"
"1363 EASTERN PARKWAY","Brooklyn","3037441","11233","308","28","0","28","5","5.6"
"1557 UNION STREET","Brooklyn","3037505","11213","309","47","0","47","8","5.9"
"964 EASTERN PARKWAY","Brooklyn","3037508","11213","309","28","12","40","12","3.3"
"970 EASTERN PARKWAY","Brooklyn","3037509","11213","309","40","0","40","12","3.3"
"972 EASTERN PARKWAY","Brooklyn","3037510","11213","309","88","4","92","23","4"
"1018 EASTERN PARKWAY","Brooklyn","3037516","11213","309","182","0","182","34","5.4"
"1074 EASTERN PARKWAY","Brooklyn","3037545","11213","309","106","0","106","31","3.4"
"1961 UNION STREET","Brooklyn","3037634","11233","308","81","1","82","4","20.5"
"318 ROCHESTER AVENUE","Brooklyn","3037805","11213","309","78","0","78","35","2.2"
"1616 PRESIDENT STREET","Brooklyn","3037905","11213","309","83","1","84","25","3.4"
"1703 CARROLL STREET","Brooklyn","3037989","11213","309","18","0","18","4","4.5"
"1695 CARROLL STREET","Brooklyn","3037992","11213","309","31","0","31","4","7.8"
"615 CROWN STREET","Brooklyn","3038029","11213","309","112","0","112","27","4.1"
"799 CROWN STREET","Brooklyn","3038188","11213","309","24","0","24","4","6"
"401 TROY AVENUE","Brooklyn","3038214","11213","309","19","0","19","5","3.8"
"871 MONTGOMERY STREET","Brooklyn","3038252","11213","309","48","0","48","4","12"
"865 MONTGOMERY STREET","Brooklyn","3038254","11213","309","36","0","36","4","9"
"836 CROWN STREET","Brooklyn","3038310","11213","309","162","0","162","59","2.7"
"829 EMPIRE BOULEVARD","Brooklyn","3038385","11213","309","39","3","42","9","4.7"
"928 MONTGOMERY STREET","Brooklyn","3038389","11213","309","19","0","19","4","4.8"
"972 MONTGOMERY STREET","Brooklyn","3038403","11213","309","17","2","19","4","4.8"
"988 MONTGOMERY STREET","Brooklyn","3038406","11213","309","139","0","139","53","2.6"
"2105 PACIFIC STREET","Brooklyn","3038535","11233","316","18","0","18","3","6"
"2152 ATLANTIC AVENUE","Brooklyn","3038565","11233","316","21","0","21","3","7"
"2181 PACIFIC STREET","Brooklyn","3038572","11233","316","121","0","121","15","8.1"
"2127 PACIFIC STREET","Brooklyn","3038593","11233","316","0","9","9","3","3"
"2276 ATLANTIC AVENUE","Brooklyn","3038604","11233","316","29","0","29","3","9.7"
"2292 ATLANTIC AVENUE","Brooklyn","3038610","11233","316","11","0","11","3","3.7"
"2298 ATLANTIC AVENUE","Brooklyn","3038613","11233","316","171","0","171","3","57"
"2300 ATLANTIC AVENUE","Brooklyn","3038614","11233","316","36","1","37","8","4.6"
"2362 ATLANTIC AVENUE","Brooklyn","3038655","11233","316","25","0","25","3","8.3"
"2093 DEAN STREET","Brooklyn","3038700","11233","316","36","1","37","4","9.3"
"2083 DEAN STREET","Brooklyn","3038703","11233","316","34","0","34","4","8.5"
"2375 DEAN STREET","Brooklyn","3038759","11233","316","109","0","109","13","8.4"
"2344 PACIFIC STREET","Brooklyn","3038767","11233","316","16","0","16","3","5.3"
"2352 PACIFIC STREET","Brooklyn","3038771","11233","316","26","1","27","3","9"
"2364 PACIFIC STREET","Brooklyn","3038777","11233","316","24","3","27","3","9"
"134 SACKMAN STREET","Brooklyn","3038782","11233","316","25","0","25","4","6.3"
"136 SACKMAN STREET","Brooklyn","3038783","11233","316","213","1","214","6","35.7"
"1719 EAST NEW YORK AVENUE","Brooklyn","3038825","11212","316","25","0","25","3","8.3"
"1927 BERGEN STREET","Brooklyn","3038874","11233","316","27","1","28","3","9.3"
"1919 BERGEN STREET","Brooklyn","3038878","11233","316","27","0","27","3","9"
"2446 DEAN STREET","Brooklyn","3038978","11233","316","13","0","13","3","4.3"
"1411 ST MARKS AVENUE","Brooklyn","3039016","11233","316","15","0","15","3","5"
"340 SARATOGA AVENUE","Brooklyn","3039055","11233","316","48","0","48","3","16"
"1521 ST MARKS AVENUE","Brooklyn","3039061","11233","316","15","0","15","3","5"
"1517 ST MARKS AVENUE","Brooklyn","3039063","11233","316","0","14","14","3","4.7"
"1631 ST MARKS AVENUE","Brooklyn","3039131","11233","316","35","0","35","8","4.4"
"477 RALPH AVENUE","Brooklyn","3039148","11233","316","10","2","12","3","4"
"1677 PROSPECT PLACE","Brooklyn","3039179","11233","316","41","2","43","3","14.3"
"1466 ST MARKS AVENUE","Brooklyn","3039194","11233","316","88","0","88","7","12.6"
"1864 PROSPECT PLACE","Brooklyn","3039327","11233","316","9","1","10","3","3.3"
"1873 PARK PLACE","Brooklyn","3039338","11233","316","73","0","73","3","24.3"
"1871 PARK PLACE","Brooklyn","3039339","11233","316","43","0","43","3","14.3"
"1837 PARK PLACE","Brooklyn","3039353","11233","316","24","0","24","3","8"
"1924 PROSPECT PLACE","Brooklyn","3039367","11233","316","33","0","33","4","8.3"
"1936 PROSPECT PLACE","Brooklyn","3039370","11233","316","161","3","164","4","41"
"1491 EAST NEW YORK AVENUE","Brooklyn","3039375","11212","316","25","0","25","5","5"
"1939 PARK PLACE","Brooklyn","3039376","11233","316","74","0","74","37","2"
"1682 PARK PLACE","Brooklyn","3039383","11233","316","122","0","122","20","6.1"
"417 SARATOGA AVENUE","Brooklyn","3039397","11233","316","20","0","20","6","3.3"
"1549 EASTERN PARKWAY","Brooklyn","3039411","11233","316","13","0","13","3","4.3"
"1576 EASTERN PARKWAY","Brooklyn","3039416","11233","316","11","0","11","3","3.7"
"1586 EASTERN PARKWAY","Brooklyn","3039419","11233","316","37","0","37","3","12.3"
"1588 EASTERN PARKWAY","Brooklyn","3039420","11233","316","112","0","112","3","37.3"
"410 HOPKINSON AVENUE","Brooklyn","3039426","11233","316","14","0","14","3","4.7"
"1530 EASTERN PARKWAY","Brooklyn","3039472","11233","316","86","0","86","8","10.8"
"1540 EASTERN PARKWAY","Brooklyn","3039483","11233","316","121","0","121","3","40.3"
"1488 EASTERN PARKWAY","Brooklyn","3039525","11233","316","17","0","17","3","5.7"
"1430 EASTERN PARKWAY","Brooklyn","3039556","11233","316","12","0","12","3","4"
"1429 PITKIN AVENUE","Brooklyn","3039570","11233","316","29","0","29","3","9.7"
"553 HOWARD AVENUE","Brooklyn","3039579","11233","316","266","0","266","12","22.2"
"1398 PITKIN AVENUE","Brooklyn","3039596","11233","316","16","0","16","5","3.2"
"825 MADISON STREET","Brooklyn","3039675","11221","303","44","0","44","3","14.7"
"73 RALPH AVENUE","Brooklyn","3039680","11221","303","25","0","25","6","4.2"
"969 PUTNAM AVENUE","Brooklyn","3039714","11221","303","75","0","75","8","9.4"
"920 MADISON STREET","Brooklyn","3039721","11221","303","70","0","70","13","5.4"
"1438 BROADWAY","Brooklyn","3039725","11221","303","26","1","27","3","9"
"31 HOWARD AVENUE","Brooklyn","3039736","11221","303","136","1","137","6","22.8"
"1074 PUTNAM AVENUE","Brooklyn","3039818","11221","303","25","0","25","3","8.3"
"1078 PUTNAM AVENUE","Brooklyn","3039820","11221","303","91","0","91","13","7"
"981 JEFFERSON AVENUE","Brooklyn","3039833","11221","303","31","0","31","8","3.9"
"914 JEFFERSON AVENUE","Brooklyn","3039867","11221","303","42","0","42","8","5.3"
"60 HOWARD AVENUE","Brooklyn","3039869","11221","303","18","0","18","3","6"
"992 JEFFERSON AVENUE","Brooklyn","3039903","11221","303","234","6","240","9","26.7"
"795 HALSEY STREET","Brooklyn","3039928","11233","303","25","2","27","6","4.5"
"841 HALSEY STREET","Brooklyn","3039966","11233","303","19","0","19","6","3.2"
"792 HALSEY STREET","Brooklyn","3039997","11233","303","9","0","9","3","3"
"643 MAC DONOUGH STREET","Brooklyn","3040101","11233","303","41","0","41","13","3.2"
"653 MAC DONOUGH STREET","Brooklyn","3040134","11233","303","35","3","38","6","6.3"
"667 MAC DONOUGH STREET","Brooklyn","3040183","11233","303","33","0","33","6","5.5"
"727 MAC DONOUGH STREET","Brooklyn","3040194","11233","316","46","0","46","4","11.5"
"872 MACON STREET","Brooklyn","3040210","11233","316","104","0","104","8","13"
"779 MAC DONOUGH STREET","Brooklyn","3040223","11233","316","13","0","13","3","4.3"
"747 MAC DONOUGH STREET","Brooklyn","3040236","11233","316","20","0","20","6","3.3"
"743 MAC DONOUGH STREET","Brooklyn","3040237","11233","316","42","0","42","7","6"
"737 MAC DONOUGH STREET","Brooklyn","3040240","11233","316","31","0","31","4","7.8"
"707 DECATUR STREET","Brooklyn","3040425","11233","316","17","0","17","3","5.7"
"818 MAC DONOUGH STREET","Brooklyn","3040465","11233","316","12","1","13","3","4.3"
"165 HOWARD AVENUE","Brooklyn","3040558","11233","303","44","0","44","8","5.5"
"429 BAINBRIDGE STREET","Brooklyn","3040623","11233","303","78","0","78","16","4.9"
"704 DECATUR STREET","Brooklyn","3040659","11233","316","54","0","54","7","7.7"
"629 BAINBRIDGE STREET","Brooklyn","3040723","11233","316","10","0","10","3","3.3"
"349 CHAUNCEY STREET","Brooklyn","3040806","11233","303","37","0","37","5","7.4"
"347 CHAUNCEY STREET","Brooklyn","3040807","11233","303","22","0","22","6","3.7"
"319 CHAUNCEY STREET","Brooklyn","3040816","11233","303","19","0","19","6","3.2"
"199 HOWARD AVENUE","Brooklyn","3040820","11233","303","25","3","28","6","4.7"
"191 HOWARD AVENUE","Brooklyn","3040824","11233","303","9","0","9","3","3"
"530 BAINBRIDGE STREET","Brooklyn","3040887","11233","316","15","0","15","4","3.8"
"538 BAINBRIDGE STREET","Brooklyn","3040890","11233","316","41","0","41","6","6.8"
"491 CHAUNCEY STREET","Brooklyn","3040904","11233","316","30","0","30","5","6"
"479 CHAUNCEY STREET","Brooklyn","3040909","11233","316","28","0","28","5","5.6"
"278 CHAUNCEY STREET","Brooklyn","3041003","11233","303","102","1","103","8","12.9"
"328 CHAUNCEY STREET","Brooklyn","3041033","11233","303","28","0","28","6","4.7"
"330 CHAUNCEY STREET","Brooklyn","3041034","11233","303","51","0","51","5","10.2"
"354 CHAUNCEY STREET","Brooklyn","3041044","11233","303","85","0","85","16","5.3"
"157 SARATOGA AVENUE","Brooklyn","3041071","11233","316","28","0","28","3","9.3"
"426 CHAUNCEY STREET","Brooklyn","3041095","11233","316","14","0","14","3","4.7"
"373 MARION STREET","Brooklyn","3041104","11233","316","9","6","15","4","3.8"
"319 MARION STREET","Brooklyn","3041131","11233","316","12","0","12","3","4"
"516 CHAUNCEY STREET","Brooklyn","3041175","11233","316","40","1","41","6","6.8"
"278 MARION STREET","Brooklyn","3041228","11233","303","32","0","32","7","4.6"
"195 SUMPTER STREET","Brooklyn","3041251","11233","303","25","1","26","8","3.3"
"191 SUMPTER STREET","Brooklyn","3041253","11233","303","38","1","39","8","4.9"
"205 SUMPTER STREET","Brooklyn","3041292","11233","303","197","0","197","6","32.8"
"117 HOPKINSON AVENUE","Brooklyn","3041306","11233","316","57","0","57","15","3.8"
"442 MARION STREET","Brooklyn","3041333","11233","316","34","0","34","3","11.3"
"57 ROCKAWAY AVENUE","Brooklyn","3041364","11233","316","0","25","25","3","8.3"
"375 SUMPTER STREET","Brooklyn","3041410","11233","316","27","0","27","6","4.5"
"128 HOPKINSON AVENUE","Brooklyn","3041501","11233","316","0","21","21","3","7"
"1921 FULTON STREET","Brooklyn","3041573","11233","303","107","0","107","36","3"
"68 MAC DOUGAL STREET","Brooklyn","3041585","11233","303","30","0","30","6","5"
"121 HULL STREET","Brooklyn","3041693","11233","316","10","0","10","3","3.3"
"105 HULL STREET","Brooklyn","3041697","11233","316","24","0","24","3","8"
"103 HULL STREET","Brooklyn","3041698","11233","316","10","4","14","3","4.7"
"203 HULL STREET","Brooklyn","3041728","11233","316","28","1","29","6","4.8"
"193 HULL STREET","Brooklyn","3041732","11233","316","16","0","16","3","5.3"
"187 HULL STREET","Brooklyn","3041734","11233","316","169","0","169","6","28.2"
"183 HULL STREET","Brooklyn","3041736","11233","316","7","8","15","3","5"
"211 HULL STREET","Brooklyn","3041783","11233","316","31","0","31","6","5.2"
"1997 FULTON STREET","Brooklyn","3041798","11233","316","9","1","10","3","3.3"
"82 HULL STREET","Brooklyn","3041831","11233","316","18","0","18","3","6"
"85 SOMERS STREET","Brooklyn","3041929","11233","316","29","5","34","3","11.3"
"218 HULL STREET","Brooklyn","3041971","11233","316","35","0","35","8","4.4"
"2055 FULTON STREET","Brooklyn","3042000","11233","316","0","12","12","4","3"
"56A SOMERS STREET","Brooklyn","3042013","11233","316","18","0","18","3","6"
"101 TRUXTON STREET","Brooklyn","3042083","11233","316","23","0","23","3","7.7"
"1984 FULTON STREET","Brooklyn","3042094","11233","303","80","0","80","6","13.3"
"2008 FULTON STREET","Brooklyn","3042110","11233","303","96","0","96","3","32"
"1115 HERKIMER STREET","Brooklyn","3042122","11233","303","15","0","15","3","5"
"2172 FULTON STREET","Brooklyn","3042242","11233","316","16","0","16","4","4"
"2182 FULTON STREET","Brooklyn","3042248","11233","316","65","2","67","7","9.6"
"2204 FULTON STREET","Brooklyn","3042259","11233","316","235","1","236","4","59"
"2206 FULTON STREET","Brooklyn","3042261","11233","316","13","1","14","3","4.7"
"1449 HERKIMER STREET","Brooklyn","3042315","11233","316","41","1","42","3","14"
"255 SARATOGA AVENUE","Brooklyn","3042428","11233","316","44","0","44","3","14.7"
"1122 HERKIMER STREET","Brooklyn","3042432","11233","316","28","0","28","3","9.3"
"1258 HERKIMER STREET","Brooklyn","3042553","11233","316","19","0","19","3","6.3"
"15 PLEASANT PLACE","Brooklyn","3042645","11233","316","42","0","42","3","14"
"1328 HERKIMER STREET","Brooklyn","3042652","11233","316","91","0","91","3","30.3"
"1336 HERKIMER STREET","Brooklyn","3042656","11233","316","9","0","9","3","3"
"1871 EASTERN PARKWAY","Brooklyn","3042690","11233","316","79","0","79","3","26.3"
"1869 EASTERN PARKWAY","Brooklyn","3042691","11233","316","130","0","130","3","43.3"
"1420 HERKIMER STREET","Brooklyn","3042729","11233","316","25","0","25","3","8.3"
"1444 HERKIMER STREET","Brooklyn","3042765","11233","316","9","0","9","3","3"
"25 MARCUS GARVEY AVENUE","Brooklyn","3042823","11206","303","9","0","9","3","3"
"948 BROADWAY","Brooklyn","3042898","11221","303","15","0","15","5","3"
"353 VERNON AVENUE","Brooklyn","3042913","11206","303","18","0","18","4","4.5"
"22 STUYVESANT AVENUE","Brooklyn","3042950","11221","303","31","1","32","8","4"
"819 WILLOUGHBY AVENUE","Brooklyn","3042956","11206","303","51","1","52","8","6.5"
"994 BROADWAY","Brooklyn","3042985","11221","303","10","0","10","3","3.3"
"752 WILLOUGHBY AVENUE","Brooklyn","3043010","11206","303","31","0","31","4","7.8"
"277 HART STREET","Brooklyn","3043045","11206","303","12","0","12","4","3"
"856 WILLOUGHBY AVENUE","Brooklyn","3043048","11221","303","101","0","101","8","12.6"
"316 HART STREET","Brooklyn","3043075","11206","303","9","0","9","3","3"
"88 LEWIS AVENUE","Brooklyn","3043086","11206","303","11","0","11","3","3.7"
"313 PULASKI STREET","Brooklyn","3043099","11206","303","8","1","9","3","3"
"63 STUYVESANT AVENUE","Brooklyn","3043162","11221","303","20","0","20","6","3.3"
"4 MALCOLM X BOULEVARD","Brooklyn","3043176","11221","303","89","0","89","10","8.9"
"399 KOSCIUSKO STREET","Brooklyn","3043225","11221","303","94","2","96","12","8"
"383 KOSCIUSKO STREET","Brooklyn","3043229","11221","303","0","16","16","3","5.3"
"533 KOSCIUSKO STREET","Brooklyn","3043288","11221","303","11","0","11","3","3.7"
"981 LAFAYETTE AVENUE","Brooklyn","3043486","11221","303","15","3","18","3","6"
"884 LAFAYETTE AVENUE","Brooklyn","3043531","11221","303","23","1","24","3","8"
"886 LAFAYETTE AVENUE","Brooklyn","3043532","11221","303","44","1","45","3","15"
"211 VAN BUREN STREET","Brooklyn","3043553","11221","303","24","0","24","3","8"
"936A LAFAYETTE AVENUE","Brooklyn","3043600","11221","303","16","0","16","3","5.3"
"481 VAN BUREN STREET","Brooklyn","3043670","11221","303","88","0","88","17","5.2"
"857 GREENE AVENUE","Brooklyn","3043787","11221","303","32","0","32","8","4"
"815 GREENE AVENUE","Brooklyn","3043811","11221","303","83","14","97","9","10.8"
"909 GREENE AVENUE","Brooklyn","3043827","11221","303","3","7","10","3","3.3"
"32 PATCHEN AVENUE","Brooklyn","3043890","11221","303","25","0","25","6","4.2"
"977 GREENE AVENUE","Brooklyn","3043895","11221","303","24","0","24","3","8"
"241 MARCUS GARVEY AVENUE","Brooklyn","3043948","11221","303","10","0","10","3","3.3"
"772 GREENE AVENUE","Brooklyn","3043970","11221","303","9","0","9","3","3"
"808 GREENE AVENUE","Brooklyn","3044027","11221","303","9","0","9","3","3"
"856 GREENE AVENUE","Brooklyn","3044051","11221","303","17","0","17","4","4.3"
"1046 GREENE AVENUE","Brooklyn","3044193","11221","303","67","0","67","12","5.6"
"564 LEXINGTON AVENUE","Brooklyn","3044225","11221","303","12","0","12","4","3"
"567 QUINCY STREET","Brooklyn","3044236","11221","303","9","0","9","3","3"
"553 QUINCY STREET","Brooklyn","3044243","11221","303","88","5","93","3","31"
"551 QUINCY STREET","Brooklyn","3044244","11221","303","22","0","22","3","7.3"
"60 PATCHEN AVENUE","Brooklyn","3044374","11221","303","62","0","62","8","7.8"
"62 PATCHEN AVENUE","Brooklyn","3044375","11221","303","39","0","39","8","4.9"
"787 QUINCY STREET","Brooklyn","3044457","11221","303","31","0","31","9","3.4"
"125 MALCOLM X BOULEVARD","Brooklyn","3044525","11221","303","6","3","9","3","3"
"709 PUTNAM AVENUE","Brooklyn","3045160","11221","303","150","18","168","6","28"
"233 STUYVESANT AVENUE","Brooklyn","3045199","11221","303","56","0","56","8","7"
"763 PUTNAM AVENUE","Brooklyn","3045225","11221","303","44","0","44","6","7.3"
"834 MADISON STREET","Brooklyn","3045329","11221","303","17","0","17","3","5.7"
"931 PUTNAM AVENUE","Brooklyn","3045344","11221","303","53","0","53","4","13.3"
"685 JEFFERSON AVENUE","Brooklyn","3045508","11221","303","27","0","27","8","3.4"
"950 PUTNAM AVENUE","Brooklyn","3045628","11221","303","13","0","13","3","4.3"
"92 RALPH AVENUE","Brooklyn","3045631","11221","303","24","0","24","6","4"
"494 JEFFERSON AVENUE","Brooklyn","3045659","11221","303","24","0","24","8","3"
"545 HANCOCK STREET","Brooklyn","3045778","11233","303","12","0","12","3","0"
"575 HANCOCK STREET","Brooklyn","3045800","11233","303","97","0","97","24","4"
"770 JEFFERSON AVENUE","Brooklyn","3045923","11221","303","30","0","30","8","3.8"
"478 HANCOCK STREET","Brooklyn","3046019","11233","303","9","2","11","3","3.7"
"631 HALSEY STREET","Brooklyn","3046242","11233","303","17","3","20","3","6.7"
"675 HALSEY STREET","Brooklyn","3046345","11233","303","104","0","104","6","17.3"
"671 HALSEY STREET","Brooklyn","3046347","11233","303","32","0","32","6","5.3"
"669 HALSEY STREET","Brooklyn","3046348","11233","303","23","0","23","6","3.8"
"363 MACON STREET","Brooklyn","3046402","11233","303","19","1","20","6","3.3"
"320 STUYVESANT AVENUE","Brooklyn","3046434","11233","303","0","13","13","3","4.3"
"225 MAC DONOUGH STREET","Brooklyn","3046780","11233","303","0","30","30","3","10"
"345 STUYVESANT AVENUE","Brooklyn","3046859","11233","303","46","0","46","4","11.5"
"265 MALCOLM X BOULEVARD","Brooklyn","3046892","11233","303","0","28","28","7","4"
"412 MAC DONOUGH STREET","Brooklyn","3047144","11233","303","21","1","22","7","3.1"
"170 DECATUR STREET","Brooklyn","3047370","11233","303","72","0","72","20","3.6"
"312 DECATUR STREET","Brooklyn","3047483","11233","303","9","0","9","3","3"
"221 BAINBRIDGE STREET","Brooklyn","3047616","11233","303","40","0","40","9","4.4"
"448 DECATUR STREET","Brooklyn","3047630","11233","303","11","2","13","3","4.3"
"120A BAINBRIDGE STREET","Brooklyn","3047734","11233","303","22","0","22","3","7.3"
"173 CHAUNCEY STREET","Brooklyn","3047845","11233","303","46","0","46","6","7.7"
"242 BAINBRIDGE STREET","Brooklyn","3047862","11233","303","26","0","26","8","3.3"
"244 BAINBRIDGE STREET","Brooklyn","3047863","11233","303","50","0","50","8","6.3"
"82 MARION STREET","Brooklyn","3047916","11233","303","31","0","31","8","3.9"
"312 PATCHEN AVENUE","Brooklyn","3047921","11233","303","12","0","12","4","3"
"575 HERKIMER STREET","Brooklyn","3047981","11213","303","144","2","146","38","3.8"
"33 BUFFALO AVENUE","Brooklyn","3048241","11233","303","26","0","26","6","4.3"
"131 TOMPKINS AVENUE","Brooklyn","3048663","11206","303","9","0","9","3","3"
"956 MYRTLE AVENUE","Brooklyn","3048697","11206","303","14","0","14","4","3.5"
"8 VERNON AVENUE","Brooklyn","3048742","11206","303","86","0","86","16","5.4"
"12 VERNON AVENUE","Brooklyn","3048743","11206","303","55","0","55","16","3.4"
"611 MARCY AVENUE","Brooklyn","3048811","11206","303","18","0","18","5","3.6"
"601 MARCY AVENUE","Brooklyn","3048813","11206","303","204","3","207","20","10.3"
"521 WILLOUGHBY AVENUE","Brooklyn","3048825","11206","303","11","0","11","3","3.7"
"160 VERNON AVENUE","Brooklyn","3048832","11206","303","57","0","57","16","3.6"
"162 VERNON AVENUE","Brooklyn","3048833","11206","303","25","2","27","4","6.8"
"266 THROOP AVENUE","Brooklyn","3048853","11206","303","9","0","9","3","3"
"621 WILLOUGHBY AVENUE","Brooklyn","3048870","11206","303","126","0","126","3","42"
"611 WILLOUGHBY AVENUE","Brooklyn","3048875","11206","303","33","0","33","9","3.7"
"607 WILLOUGHBY AVENUE","Brooklyn","3048877","11206","303","37","0","37","9","4.1"
"685 WILLOUGHBY AVENUE","Brooklyn","3048924","11206","303","9","0","9","3","3"
"570 WILLOUGHBY AVENUE","Brooklyn","3049130","11206","303","31","0","31","8","3.9"
"150 TOMPKINS AVENUE","Brooklyn","3049131","11206","303","100","1","101","20","5"
"664 WILLOUGHBY AVENUE","Brooklyn","3049208","11206","303","84","0","84","36","2.3"
"18 HART STREET","Brooklyn","3049246","11206","303","14","0","14","3","4.7"
"199 PULASKI STREET","Brooklyn","3049387","11206","303","185","1","186","9","20.7"
"98 PULASKI STREET","Brooklyn","3049485","11206","303","47","4","51","5","10.2"
"100 PULASKI STREET","Brooklyn","3049486","11206","303","97","0","97","16","6.1"
"148 MARCUS GARVEY AVENUE","Brooklyn","3049570","11206","303","41","0","41","11","3.7"
"152 MARCUS GARVEY AVENUE","Brooklyn","3049571","11206","303","109","0","109","16","6.8"
"979 BEDFORD AVENUE","Brooklyn","3049596","11205","303","20","0","20","3","6.7"
"209 KOSCIUSKO STREET","Brooklyn","3049634","11216","303","17","0","17","3","5.7"
"207 KOSCIUSKO STREET","Brooklyn","3049635","11216","303","10","0","10","3","3.3"
"503 LAFAYETTE AVENUE","Brooklyn","3049763","11205","303","15","11","26","7","3.7"
"662 LAFAYETTE AVENUE","Brooklyn","3049805","11216","303","20","0","20","3","6.7"
"660 LAFAYETTE AVENUE","Brooklyn","3049807","11216","303","15","0","15","5","3"
"235 TOMPKINS AVENUE","Brooklyn","3049808","11216","303","76","0","76","8","9.5"
"284 KOSCIUSKO STREET","Brooklyn","3049830","11221","303","50","0","50","8","6.3"
"286 KOSCIUSKO STREET","Brooklyn","3049831","11221","303","25","0","25","8","3.1"
"749 LAFAYETTE AVENUE","Brooklyn","3049835","11221","303","71","0","71","8","8.9"
"745 LAFAYETTE AVENUE","Brooklyn","3049836","11221","303","88","0","88","13","6.8"
"709 LAFAYETTE AVENUE","Brooklyn","3049846","11221","303","98","0","98","24","4.1"
"308 KOSCIUSKO STREET","Brooklyn","3049857","11221","303","29","0","29","8","3.6"
"532 LAFAYETTE AVENUE","Brooklyn","3049874","11205","303","10","1","11","3","3.7"
"798 LAFAYETTE AVENUE","Brooklyn","3050038","11221","303","11","0","11","3","3.7"
"316 CLIFTON PLACE","Brooklyn","3050112","11216","303","40","0","40","11","3.6"
"40 VAN BUREN STREET","Brooklyn","3050223","11221","303","23","0","23","3","7.7"
"609 GREENE AVENUE","Brooklyn","3050267","11221","303","23","0","23","6","3.8"
"679 GREENE AVENUE","Brooklyn","3050318","11221","303","12","0","12","4","3"
"420 GREENE AVENUE","Brooklyn","3050333","11216","303","22","0","22","4","5.5"
"566 GREENE AVENUE","Brooklyn","3050423","11216","303","38","0","38","11","3.5"
"585 GREENE AVENUE","Brooklyn","3050437","11216","303","14","0","14","3","4.7"
"628 GREENE AVENUE","Brooklyn","3050457","11221","303","0","9","9","3","3"
"173 QUINCY STREET","Brooklyn","3050604","11216","303","16","0","16","3","5.3"
"315 NOSTRAND AVENUE","Brooklyn","3050617","11216","303","9","0","9","3","3"
"281 QUINCY STREET","Brooklyn","3050644","11216","303","121","1","122","25","4.9"
"257 QUINCY STREET","Brooklyn","3050654","11216","303","85","1","86","21","4.1"
"345 QUINCY STREET","Brooklyn","3050703","11216","303","19","3","22","3","7.3"
"375 GATES AVENUE","Brooklyn","3050852","11216","303","76","0","76","12","6.3"
"425 GATES AVENUE","Brooklyn","3050908","11216","303","170","0","170","11","15.5"
"587 GATES AVENUE","Brooklyn","3051021","11221","303","25","0","25","8","3.1"
"480 QUINCY STREET","Brooklyn","3051033","11221","303","251","2","253","3","84.3"
"426 GATES AVENUE","Brooklyn","3051109","11216","303","48","0","48","3","16"
"808 MARCY AVENUE","Brooklyn","3051122","11216","303","17","0","17","3","5.7"
"273 MONROE STREET","Brooklyn","3051124","11216","303","24","0","24","6","4"
"476 GATES AVENUE","Brooklyn","3051161","11216","303","30","0","30","7","4.3"
"142 MONROE STREET","Brooklyn","3051299","11216","303","27","0","27","8","3.4"
"373 NOSTRAND AVENUE","Brooklyn","3051366","11216","303","22","0","22","4","5.5"
"822 MARCY AVENUE","Brooklyn","3051409","11216","303","49","0","49","6","8.2"
"826 MARCY AVENUE","Brooklyn","3051410","11216","303","21","0","21","7","3"
"823 MARCY AVENUE","Brooklyn","3051450","11216","303","15","0","15","4","3.8"
"351 TOMPKINS AVENUE","Brooklyn","3051468","11216","303","24","0","24","3","8"
"411 MADISON STREET","Brooklyn","3051512","11221","303","0","14","14","4","3.5"
"144 MADISON STREET","Brooklyn","3051550","11216","303","54","0","54","16","3.4"
"200 MADISON STREET","Brooklyn","3051571","11216","303","0","20","20","4","5"
"239 PUTNAM AVENUE","Brooklyn","3051605","11216","303","25","0","25","8","3.1"
"246 MADISON STREET","Brooklyn","3051637","11216","303","42","0","42","8","5.3"
"415 PUTNAM AVENUE","Brooklyn","3051688","11216","303","51","2","53","4","13.3"
"389 PUTNAM AVENUE","Brooklyn","3051701","11216","303","12","0","12","3","4"
"385 A PUTNAM AVENUE","Brooklyn","3051703","11216","303","34","0","34","7","4.9"
"438 MADISON STREET","Brooklyn","3051783","11221","303","34","1","35","3","11.7"
"440 MADISON STREET","Brooklyn","3051784","11221","303","20","0","20","6","3.3"
"446 MADISON STREET","Brooklyn","3051787","11221","303","36","0","36","6","6"
"448 MADISON STREET","Brooklyn","3051788","11221","303","19","0","19","6","3.2"
"450 MADISON STREET","Brooklyn","3051789","11221","303","29","0","29","6","4.8"
"452 MADISON STREET","Brooklyn","3051790","11221","303","18","1","19","6","3.2"
"464 MADISON STREET","Brooklyn","3051795","11221","303","87","1","88","6","14.7"
"232A PUTNAM AVENUE","Brooklyn","3051849","11216","303","57","0","57","3","19"
"334 PUTNAM AVENUE","Brooklyn","3051922","11216","303","60","0","60","6","10"
"438 PUTNAM AVENUE","Brooklyn","3052052","11221","303","43","0","43","3","14.3"
"377 JEFFERSON AVENUE","Brooklyn","3052100","11221","303","15","3","18","5","3.6"
"355 JEFFERSON AVENUE","Brooklyn","3052112","11221","303","10","0","10","3","3.3"
"356 MARCUS GARVEY AVENUE","Brooklyn","3052162","11221","303","11","0","11","3","3.7"
"358 MARCUS GARVEY AVENUE","Brooklyn","3052163","11221","303","15","0","15","3","5"
"461 JEFFERSON AVENUE","Brooklyn","3052176","11221","303","14","0","14","3","4.7"
"165 HANCOCK STREET","Brooklyn","3052337","11216","303","32","0","32","4","8"
"155 HANCOCK STREET","Brooklyn","3052342","11216","303","29","1","30","10","3"
"400 TOMPKINS AVENUE","Brooklyn","3052379","11216","303","117","0","117","15","7.8"
"402 TOMPKINS AVENUE","Brooklyn","3052380","11216","303","31","0","31","6","5.2"
"409 TOMPKINS AVENUE","Brooklyn","3052412","11216","303","19","0","19","4","4.8"
"346 JEFFERSON AVENUE","Brooklyn","3052414","11221","303","81","0","81","9","9"
"333 HANCOCK STREET","Brooklyn","3052473","11216","303","25","0","25","8","3.1"
"309 HANCOCK STREET","Brooklyn","3052485","11216","303","42","0","42","4","10.5"
"464A JEFFERSON AVENUE","Brooklyn","3052516","11221","303","10","0","10","3","3.3"
"470 JEFFERSON AVENUE","Brooklyn","3052519","11221","303","30","0","30","9","3.3"
"128 HANCOCK STREET","Brooklyn","3052603","11216","303","36","0","36","8","4.5"
"13 HALSEY STREET","Brooklyn","3052650","11216","303","51","0","51","9","5.7"
"236 HANCOCK STREET","Brooklyn","3052730","11216","303","22","0","22","6","3.7"
"187 HALSEY STREET","Brooklyn","3052787","11216","303","44","0","44","3","14.7"
"398 HANCOCK STREET","Brooklyn","3052879","11216","303","9","0","9","3","3"
"68 HALSEY STREET","Brooklyn","3053002","11216","303","23","0","23","4","5.8"
"455 TOMPKINS AVENUE","Brooklyn","3053076","11216","303","82","4","86","8","10.8"
"203 MACON STREET","Brooklyn","3053139","11216","303","62","0","62","8","7.8"
"380 HALSEY STREET","Brooklyn","3053167","11216","303","13","0","13","3","4.3"
"118 MACON STREET","Brooklyn","3053294","11216","303","22","0","22","6","3.7"
"25 MAC DONOUGH STREET","Brooklyn","3053337","11216","303","249","0","249","19","13.1"
"473 TOMPKINS AVENUE","Brooklyn","3053347","11216","303","18","1","19","3","6.3"
"469 TOMPKINS AVENUE","Brooklyn","3053349","11216","303","29","5","34","4","8.5"
"622 THROOP AVENUE","Brooklyn","3053380","11216","303","84","2","86","8","10.8"
"133 MAC DONOUGH STREET","Brooklyn","3053382","11216","303","371","5","376","8","47"
"310 MACON STREET","Brooklyn","3053416","11216","303","9","0","9","3","3"
"30 MAC DONOUGH STREET","Brooklyn","3053455","11216","303","80","2","82","16","5.1"
"31 DECATUR STREET","Brooklyn","3053543","11216","303","38","1","39","4","9.8"
"1511 FULTON STREET","Brooklyn","3053623","11216","303","15","0","15","3","5"
"1507 FULTON STREET","Brooklyn","3053625","11216","303","20","0","20","3","6.7"
"4 DECATUR STREET","Brooklyn","3053645","11216","303","211","33","244","16","15.3"
"629 THROOP AVENUE","Brooklyn","3053661","11216","303","12","0","12","3","4"
"175 HERKIMER STREET","Brooklyn","3053764","11216","303","53","5","58","3","19.3"
"1470 FULTON STREET","Brooklyn","3053810","11216","303","25","1","26","6","4.3"
"1 KINGSTON AVENUE","Brooklyn","3053838","11213","303","57","2","59","3","19.7"
"429 HERKIMER STREET","Brooklyn","3053862","11213","303","18","0","18","3","6"
"140 HERKIMER STREET","Brooklyn","3053955","11216","303","105","0","105","16","6.6"
"146 HERKIMER STREET","Brooklyn","3053956","11216","303","70","1","71","4","17.8"
"48 NEW YORK AVENUE","Brooklyn","3053982","11216","303","33","0","33","3","11"
"1511 ATLANTIC AVENUE","Brooklyn","3054055","11213","303","107","0","107","3","35.7"
"1507 ATLANTIC AVENUE","Brooklyn","3054057","11213","303","12","0","12","3","4"
"90 CLINTON AVENUE","Brooklyn","3054278","11205","302","44","0","44","8","5.5"
"94 CLINTON AVENUE","Brooklyn","3054279","11205","302","47","0","47","8","5.9"
"87 WAVERLY AVENUE","Brooklyn","3054357","11205","302","35","9","44","3","14.7"
"85 WAVERLY AVENUE","Brooklyn","3054358","11205","302","47","2","49","3","16.3"
"154 WASHINGTON AVENUE","Brooklyn","3054395","11205","302","3","11","14","3","4.7"
"102 RYERSON STREET","Brooklyn","3054505","11205","302","0","17","17","3","5.7"
"125 RYERSON STREET","Brooklyn","3054530","11205","302","28","0","28","3","9.3"
"104 STEUBEN STREET","Brooklyn","3054587","11205","302","25","0","25","3","8.3"
"95 FRANKLIN AVENUE","Brooklyn","3054735","11205","303","20","0","20","3","6.7"
"645 MYRTLE AVENUE","Brooklyn","3054752","11205","303","30","1","31","6","5.2"
"448 MYRTLE AVENUE","Brooklyn","3054811","11205","302","15","5","20","3","6.7"
"155 EMERSON PLACE","Brooklyn","3054898","11205","302","92","0","92","38","2.4"
"162 FRANKLIN AVENUE","Brooklyn","3054944","11205","303","104","0","104","6","17.3"
"262 CLINTON AVENUE","Brooklyn","3055022","11205","302","85","1","86","6","14.3"
"485 DE KALB AVENUE","Brooklyn","3055168","11205","303","38","0","38","6","6.3"
"970 BEDFORD AVENUE","Brooklyn","3055252","11205","303","20","0","20","5","4"
"510 DE KALB AVENUE","Brooklyn","3055427","11205","303","19","0","19","3","6.3"
"356 LAFAYETTE AVENUE","Brooklyn","3055587","11238","302","29","0","29","8","3.6"
"362 LAFAYETTE AVENUE","Brooklyn","3055589","11238","302","20","1","21","4","5.3"
"183 CLIFTON PLACE","Brooklyn","3055698","11216","303","21","2","23","3","7.7"
"327 FRANKLIN AVENUE","Brooklyn","3055807","11238","303","60","0","60","16","3.8"
"355 GREENE AVENUE","Brooklyn","3055842","11216","303","122","0","122","8","15.3"
"46 GREENE AVENUE","Brooklyn","3055849","11238","302","91","6","97","39","2.5"
"405 CLERMONT AVENUE","Brooklyn","3055921","11238","302","1","17","18","4","4.5"
"43 GATES AVENUE","Brooklyn","3055983","11238","302","36","0","36","12","3"
"118 ST JAMES PLACE","Brooklyn","3056070","11238","302","57","0","57","6","9.5"
"353 FRANKLIN AVENUE","Brooklyn","3056333","11238","303","8","1","9","3","3"
"376 GREENE AVENUE","Brooklyn","3056349","11216","303","24","7","31","9","3.4"
"90 LEXINGTON AVENUE","Brooklyn","3056418","11238","303","25","0","25","8","3.1"
"367 FRANKLIN AVENUE","Brooklyn","3056448","11238","303","16","0","16","3","5.3"
"1098 BEDFORD AVENUE","Brooklyn","3056463","11216","303","20","0","20","6","3.3"
"249 GATES AVENUE","Brooklyn","3056554","11238","303","23","0","23","3","7.7"
"391 FRANKLIN AVENUE","Brooklyn","3056589","11238","303","63","11","74","35","2.1"
"921 FULTON STREET","Brooklyn","3056626","11238","302","10","0","10","3","3.3"
"418 GRAND AVENUE","Brooklyn","3056788","11238","302","16","0","16","4","4"
"463 CLASSON AVENUE","Brooklyn","3056956","11238","303","37","8","45","10","4.5"
"80 MONROE STREET","Brooklyn","3057121","11216","303","39","0","39","9","4.3"
"463 FRANKLIN AVENUE","Brooklyn","3057327","11238","303","14","0","14","3","4.7"
"21 SPENCER PLACE","Brooklyn","3057441","11216","303","49","1","50","8","6.3"
"19 SPENCER PLACE","Brooklyn","3057442","11216","303","37","0","37","5","7.4"
"17 SPENCER PLACE","Brooklyn","3057443","11216","303","104","0","104","4","26"
"44 HANCOCK STREET","Brooklyn","3057451","11216","303","24","0","24","7","3.4"
"105 LEFFERTS PLACE","Brooklyn","3057679","11238","302","163","0","163","33","4.9"
"89 LEFFERTS PLACE","Brooklyn","3057680","11238","302","103","1","104","32","3.3"
"1128 FULTON STREET","Brooklyn","3057720","11238","303","38","0","38","6","6.3"
"1166 FULTON STREET","Brooklyn","3057758","11216","303","19","1","20","6","3.3"
"1172 FULTON STREET","Brooklyn","3057761","11216","303","24","0","24","3","8"
"31 BREVOORT PLACE","Brooklyn","3057773","11216","303","14","0","14","4","3.5"
"163 PARK AVENUE","Brooklyn","3058004","11205","302","64","0","64","7","9.1"
"102 DE KALB AVENUE","Brooklyn","3058604","11201","302","18","0","18","4","4.5"
"79 FORT GREENE PLACE","Brooklyn","3058745","11217","302","15","0","15","4","3.8"
"40 SOUTH OXFORD STREET","Brooklyn","3058908","11217","302","22","0","22","3","7.3"
"133 LAFAYETTE AVENUE","Brooklyn","3059045","11238","302","20","0","20","6","3.3"
"101 SOUTH ELLIOTT PLACE","Brooklyn","3059273","11217","302","171","2","173","7","24.7"
"208 BROADWAY","Brooklyn","3059551","11211","301","48","0","48","3","16"
"77 SOUTH 9 STREET","Brooklyn","3059576","11249","301","12","0","12","4","3"
"110 LEE AVENUE","Brooklyn","3060172","11211","301","8","22","30","8","3.8"
"178 HOOPER STREET","Brooklyn","3060353","11211","301","102","0","102","35","2.9"
"298 HOOPER STREET","Brooklyn","3060462","11211","301","15","0","15","5","3"
"154 PENN STREET","Brooklyn","3060777","11211","301","0","22","22","3","7.3"
"216 PENN STREET","Brooklyn","3060844","11211","301","20","0","20","3","6.7"
"146 NORTH    9 STREET","Brooklyn","3061782","11249","301","138","0","138","8","17.3"
"143 NORTH    7 STREET","Brooklyn","3061933","11249","301","37","0","37","8","4.6"
"212 NORTH 8 STREET","Brooklyn","3061968","11211","301","39","0","39","8","4.9"
"213 NORTH    5 STREET","Brooklyn","3062247","11211","301","43","6","49","6","8.2"
"127 GRAND STREET","Brooklyn","3062610","11249","301","54","0","54","13","4.2"
"335 GRAND STREET","Brooklyn","3062701","11211","301","12","0","12","4","3"
"377 SOUTH    1 STREET","Brooklyn","3062876","11211","301","36","0","36","8","4.5"
"183 SOUTH 2 STREET","Brooklyn","3062995","11211","301","59","16","75","3","25"
"335 SOUTH 2 STREET","Brooklyn","3063037","11211","301","89","0","89","20","4.5"
"356 SOUTH    1 STREET","Brooklyn","3063042","11211","301","97","0","97","35","2.8"
"128 SOUTH    2 STREET","Brooklyn","3063094","11249","301","0","11","11","3","3.7"
"109 SOUTH    3 STREET","Brooklyn","3063104","11249","301","23","0","23","4","5.8"
"380 HOOPER STREET","Brooklyn","3063209","11211","301","87","0","87","6","14.5"
"62 SOUTH    3 STREET","Brooklyn","3063229","11249","301","0","15","15","4","3.8"
"338 SOUTH    3 STREET","Brooklyn","3063350","11211","301","219","15","234","41","5.7"
"365 SOUTH 4 STREET","Brooklyn","3063356","11211","301","34","5","39","6","6.5"
"329 SOUTH 4 STREET","Brooklyn","3063366","11211","301","7","6","13","3","4.3"
"78 SOUTH    4 STREET","Brooklyn","3063412","11249","301","12","0","12","4","3"
"333 BERRY STREET","Brooklyn","3063425","11249","301","11","6","17","4","4.3"
"418 SOUTH    4 STREET","Brooklyn","3063523","11211","301","20","0","20","6","3.3"
"11 NEW MONTROSE AVENUE","Brooklyn","3063628","11211","301","73","0","73","35","2.1"
"104 CLAY STREET","Brooklyn","3063772","11222","301","31","1","32","8","4"
"90 EAGLE STREET","Brooklyn","3063903","11222","301","26","0","26","6","4.3"
"111 FREEMAN STREET","Brooklyn","3063943","11222","301","33","0","33","6","5.5"
"143 GREEN STREET","Brooklyn","3064045","11222","301","61","4","65","6","10.8"
"220 FRANKLIN STREET","Brooklyn","3064137","11222","301","14","16","30","8","3.8"
"47 INDIA STREET","Brooklyn","3064250","11222","301","30","0","30","8","3.8"
"202 FRANKLIN STREET","Brooklyn","3064254","11222","301","23","0","23","6","3.8"
"196 HURON STREET","Brooklyn","3064326","11222","301","81","2","83","6","13.8"
"183 INDIA STREET","Brooklyn","3064339","11222","301","57","0","57","8","7.1"
"187 MC GUINNESS BOULEVARD","Brooklyn","3065396","11222","301","10","0","10","3","3.3"
"110 MESEROLE AVENUE","Brooklyn","3065618","11222","301","18","0","18","6","3"
"85 NEWELL STREET","Brooklyn","3066245","11222","301","23","0","23","6","3.8"
"233 NORTH HENRY STREET","Brooklyn","3066478","11222","301","26","0","26","6","4.3"
"192 NASSAU AVENUE","Brooklyn","3067038","11222","301","18","4","22","4","5.5"
"206 NASSAU AVENUE","Brooklyn","3067045","11222","301","29","0","29","6","4.8"
"137 RUSSELL STREET","Brooklyn","3067049","11222","301","28","0","28","6","4.7"
"219 KINGSLAND AVENUE","Brooklyn","3067138","11222","301","126","4","130","16","8.1"
"290 NASSAU AVENUE","Brooklyn","3067335","11222","301","15","0","15","5","3"
"787 MEEKER AVENUE","Brooklyn","3067498","11222","301","14","0","14","4","3.5"
"103 MONITOR STREET","Brooklyn","3067715","11222","301","18","0","18","3","6"
"174 BAYARD STREET","Brooklyn","3067961","11222","301","13","0","13","3","4.3"
"545 MEEKER AVENUE","Brooklyn","3068016","11222","301","28","1","29","6","4.8"
"593 MEEKER AVENUE","Brooklyn","3068023","11222","301","12","1","13","4","3.3"
"97 JACKSON STREET","Brooklyn","3068287","11211","301","84","1","85","6","14.2"
"366 A MANHATTAN AVENUE","Brooklyn","3068292","11211","301","16","0","16","4","4"
"429 HUMBOLDT STREET","Brooklyn","3068334","11211","301","11","0","11","3","3.7"
"234 POWERS STREET","Brooklyn","3069476","11211","301","19","0","19","6","3.2"
"90 BUSHWICK AVENUE","Brooklyn","3069482","11211","301","83","3","86","12","7.2"
"139 MAUJER STREET","Brooklyn","3069577","11206","301","15","1","16","5","3.2"
"224 MANHATTAN AVENUE","Brooklyn","3069578","11206","301","26","5","31","5","6.2"
"55 TENEYCK STREET","Brooklyn","3069677","11206","301","53","0","53","6","8.8"
"111 KINGSLAND AVENUE","Brooklyn","3069828","11222","301","37","0","37","5","7.4"
"19 KINGSLAND AVENUE","Brooklyn","3070195","11211","301","38","2","40","6","6.7"
"16 JUDGE STREET","Brooklyn","3070414","11211","301","68","0","68","8","8.5"
"112 HARRISON PLACE","Brooklyn","3070670","11237","301","17","0","17","5","3.4"
"105 GRATTAN STREET","Brooklyn","3070673","11237","301","18","0","18","6","3"
"147 THAMES STREET","Brooklyn","3070709","11237","301","29","0","29","6","4.8"
"155 MANHATTAN AVENUE","Brooklyn","3070959","11206","301","12","0","12","3","4"
"142 SCHOLES STREET","Brooklyn","3070975","11206","301","38","0","38","12","3.2"
"206 BUSHWICK AVENUE","Brooklyn","3071015","11206","301","25","0","25","7","3.6"
"128 MESEROLE STREET","Brooklyn","3071111","11206","301","28","1","29","3","9.7"
"23 INGRAHAM STREET","Brooklyn","3071327","11206","301","45","0","45","6","7.5"
"82 GRAHAM AVENUE","Brooklyn","3071449","11206","301","62","0","62","6","10.3"
"84 GRAHAM AVENUE","Brooklyn","3071450","11206","301","26","0","26","6","4.3"
"387 BUSHWICK AVENUE","Brooklyn","3071529","11206","301","9","1","10","3","3.3"
"681 BROADWAY","Brooklyn","3071599","11206","301","18","3","21","4","5.3"
"794 FLUSHING AVENUE","Brooklyn","3071678","11206","304","12","0","12","4","3"
"19 PARK STREET","Brooklyn","3071729","11206","304","18","0","18","5","3.6"
"12 LOCUST STREET","Brooklyn","3071766","11206","304","29","0","29","5","5.8"
"16 BELVEDERE STREET","Brooklyn","3071789","11206","304","12","0","12","3","4"
"884 FLUSHING AVENUE","Brooklyn","3071831","11206","304","28","0","28","6","4.7"
"942 FLUSHING AVENUE","Brooklyn","3071842","11206","304","71","0","71","6","11.8"
"153 NOLL STREET","Brooklyn","3071856","11206","304","10","5","15","5","3"
"154 NOLL STREET","Brooklyn","3071919","11206","304","12","0","12","4","3"
"180 NOLL STREET","Brooklyn","3071929","11237","304","22","12","34","3","11.3"
"68 GEORGE STREET","Brooklyn","3071943","11206","304","18","0","18","6","3"
"94 GEORGE STREET","Brooklyn","3071955","11206","304","27","1","28","6","4.7"
"1086 FLUSHING AVENUE","Brooklyn","3071994","11237","304","0","33","33","5","6.6"
"336 MELROSE STREET","Brooklyn","3072092","11237","304","27","3","30","6","5"
"190 KNICKERBOCKER AVENUE","Brooklyn","3072101","11237","304","50","2","52","6","8.7"
"414 MELROSE STREET","Brooklyn","3072128","11237","304","91","0","91","8","11.4"
"444 MELROSE STREET","Brooklyn","3072137","11237","304","17","7","24","4","6"
"22 IRVING AVENUE","Brooklyn","3072140","11237","304","33","0","33","8","4.1"
"317 JEFFERSON STREET","Brooklyn","3072142","11237","304","68","0","68","5","13.6"
"299 JEFFERSON STREET","Brooklyn","3072150","11237","304","56","0","56","8","7"
"11 TROUTMAN STREET","Brooklyn","3072187","11206","304","11","0","11","3","3.7"
"198 JEFFERSON STREET","Brooklyn","3072283","11206","304","22","0","22","6","3.7"
"242 JEFFERSON STREET","Brooklyn","3072308","11237","304","25","0","25","6","4.2"
"207 KNICKERBOCKER AVENUE","Brooklyn","3072340","11237","304","39","0","39","6","6.5"
"316 JEFFERSON STREET","Brooklyn","3072359","11237","304","50","1","51","6","8.5"
"32 IRVING AVENUE","Brooklyn","3072366","11237","304","20","0","20","4","5"
"307 TROUTMAN STREET","Brooklyn","3072376","11237","304","29","0","29","8","3.6"
"299 TROUTMAN STREET","Brooklyn","3072379","11237","304","36","5","41","8","5.1"
"283 TROUTMAN STREET","Brooklyn","3072386","11237","304","41","0","41","4","10.3"
"142 CENTRAL AVENUE","Brooklyn","3072485","11221","304","44","0","44","6","7.3"
"95 WILSON AVENUE","Brooklyn","3072504","11237","304","43","3","46","6","7.7"
"244 TROUTMAN STREET","Brooklyn","3072516","11237","304","45","0","45","6","7.5"
"223 KNICKERBOCKER AVENUE","Brooklyn","3072540","11237","304","19","0","19","6","3.2"
"44 IRVING AVENUE","Brooklyn","3072560","11237","304","33","0","33","4","8.3"
"159 STARR STREET","Brooklyn","3072574","11237","304","50","0","50","8","6.3"
"96 STARR STREET","Brooklyn","3072732","11237","304","44","0","44","6","7.3"
"1111 WILLOUGHBY AVENUE","Brooklyn","3072752","11237","304","94","11","105","6","17.5"
"58 ST NICHOLAS AVENUE","Brooklyn","3072799","11237","304","79","2","81","6","13.5"
"147 CENTRAL AVENUE","Brooklyn","3072904","11221","304","22","0","22","4","5.5"
"140 WILSON AVENUE","Brooklyn","3072912","11237","304","13","0","13","3","4.3"
"1114 WILLOUGHBY AVENUE","Brooklyn","3072930","11237","304","29","1","30","6","5"
"1130 WILLOUGHBY AVENUE","Brooklyn","3072938","11237","304","54","0","54","6","9"
"241 SUYDAM STREET","Brooklyn","3072952","11237","304","28","0","28","6","4.7"
"235 SUYDAM STREET","Brooklyn","3072954","11237","304","31","0","31","6","5.2"
"65 WYCKOFF AVENUE","Brooklyn","3072987","11237","304","26","0","26","6","4.3"
"1356 WILLOUGHBY AVENUE","Brooklyn","3072999","11237","304","21","0","21","6","3.5"
"74 ST NICHOLAS AVENUE","Brooklyn","3073005","11237","304","19","1","20","6","3.3"
"715 BUSHWICK AVENUE","Brooklyn","3073076","11221","304","67","2","69","3","23"
"567 HART STREET","Brooklyn","3073089","11221","304","38","1","39","4","9.8"
"128 SUYDAM STREET","Brooklyn","3073103","11221","304","10","5","15","4","3.8"
"150 WILSON AVENUE","Brooklyn","3073134","11237","304","35","0","35","6","5.8"
"296 KNICKERBOCKER AVENUE","Brooklyn","3073178","11237","304","19","0","19","4","4.8"
"316 SUYDAM STREET","Brooklyn","3073224","11237","304","18","0","18","6","3"
"883 HART STREET","Brooklyn","3073229","11237","304","33","0","33","6","5.5"
"871 HART STREET","Brooklyn","3073233","11237","304","22","0","22","6","3.7"
"869 HART STREET","Brooklyn","3073234","11237","304","80","0","80","6","13.3"
"406 SUYDAM STREET","Brooklyn","3073282","11237","304","19","0","19","6","3.2"
"544 HART STREET","Brooklyn","3073375","11221","304","18","0","18","6","3"
"177 WILSON AVENUE","Brooklyn","3073551","11237","304","0","13","13","4","3.3"
"325 KNICKERBOCKER AVENUE","Brooklyn","3073584","11237","304","57","1","58","6","9.7"
"818 HART STREET","Brooklyn","3073588","11237","304","52","0","52","8","6.5"
"848 HART STREET","Brooklyn","3073597","11237","304","20","1","21","6","3.5"
"124 IRVING AVENUE","Brooklyn","3073607","11237","304","23","0","23","7","3.3"
"912 HART STREET","Brooklyn","3073639","11237","304","12","0","12","4","3"
"1567 DE KALB AVENUE","Brooklyn","3073657","11237","304","24","0","24","8","3"
"1416 DE KALB AVENUE","Brooklyn","3073819","11237","304","22","0","22","6","3.7"
"1438 DE KALB AVENUE","Brooklyn","3073830","11237","304","42","0","42","6","7"
"167 STOCKHOLM STREET","Brooklyn","3073849","11237","304","29","0","29","5","5.8"
"343 KNICKERBOCKER AVENUE","Brooklyn","3073856","11237","304","24","0","24","4","6"
"1502 DE KALB AVENUE","Brooklyn","3073870","11237","304","25","0","25","6","4.2"
"1560 DE KALB AVENUE","Brooklyn","3073908","11237","304","16","0","16","5","3.2"
"1582 DE KALB AVENUE","Brooklyn","3073912","11237","304","36","1","37","6","6.2"
"137 WYCKOFF AVENUE","Brooklyn","3073932","11237","304","22","0","22","7","3.1"
"131 WYCKOFF AVENUE","Brooklyn","3073935","11237","304","108","0","108","8","13.5"
"1656 DE KALB AVENUE","Brooklyn","3073946","11237","304","21","0","21","6","3.5"
"138 ST NICHOLAS AVENUE","Brooklyn","3073952","11237","304","43","0","43","6","7.2"
"407 STOCKHOLM STREET","Brooklyn","3073992","11237","304","31","0","31","3","10.3"
"841 BUSHWICK AVENUE","Brooklyn","3074032","11221","304","9","0","9","3","3"
"829 BUSHWICK AVENUE","Brooklyn","3074035","11221","304","18","1","19","4","4.8"
"202 WILSON AVENUE","Brooklyn","3074120","11237","304","38","1","39","5","7.8"
"174 STOCKHOLM STREET","Brooklyn","3074132","11237","304","33","0","33","4","8.3"
"180 STOCKHOLM STREET","Brooklyn","3074135","11237","304","31","0","31","6","5.2"
"186 STOCKHOLM STREET","Brooklyn","3074138","11237","304","23","0","23","6","3.8"
"364 KNICKERBOCKER AVENUE","Brooklyn","3074147","11237","304","47","0","47","4","11.8"
"191 STANHOPE STREET","Brooklyn","3074155","11237","304","20","0","20","6","3.3"
"244 STOCKHOLM STREET","Brooklyn","3074189","11237","304","30","0","30","7","4.3"
"252 STOCKHOLM STREET","Brooklyn","3074193","11237","304","35","0","35","8","4.4"
"166 IRVING AVENUE","Brooklyn","3074196","11237","304","37","0","37","6","6.2"
"249 STANHOPE STREET","Brooklyn","3074210","11237","304","18","5","23","6","3.8"
"227 STANHOPE STREET","Brooklyn","3074218","11237","304","38","0","38","6","6.3"
"232 STANHOPE STREET","Brooklyn","3074483","11237","304","32","1","33","6","5.5"
"182 IRVING AVENUE","Brooklyn","3074494","11237","304","54","0","54","6","9"
"241 HIMROD STREET","Brooklyn","3074511","11237","304","18","2","20","6","3.3"
"138 WYCKOFF AVENUE","Brooklyn","3074545","11237","304","32","3","35","6","5.8"
"287 HIMROD STREET","Brooklyn","3074557","11237","304","27","0","27","6","4.5"
"171 WYCKOFF AVENUE","Brooklyn","3074568","11237","304","27","1","28","4","7"
"249 HARMAN STREET","Brooklyn","3074790","11237","304","31","0","31","6","5.2"
"315 HARMAN STREET","Brooklyn","3074831","11237","304","31","0","31","6","5.2"
"293 HARMAN STREET","Brooklyn","3074842","11237","304","24","0","24","6","4"
"156 WYCKOFF AVENUE","Brooklyn","3074864","11237","304","24","0","24","6","4"
"197 WYCKOFF AVENUE","Brooklyn","3074870","11237","304","25","0","25","6","4.2"
"370 HIMROD STREET","Brooklyn","3074879","11237","304","7","15","22","3","7.3"
"477 HARMAN STREET","Brooklyn","3074932","11237","304","20","0","20","6","3.3"
"1225 BROADWAY","Brooklyn","3074943","11221","304","21","0","21","4","5.3"
"170 HARMAN STREET","Brooklyn","3075071","11221","304","21","0","21","6","3.5"
"294 HARMAN STREET","Brooklyn","3075097","11237","304","30","0","30","6","5"
"306 HARMAN STREET","Brooklyn","3075100","11237","304","61","2","63","6","10.5"
"324 HARMAN STREET","Brooklyn","3075106","11237","304","18","0","18","6","3"
"1363 GREENE AVENUE","Brooklyn","3075116","11237","304","30","0","30","6","5"
"235 IRVING AVENUE","Brooklyn","3075140","11237","304","156","10","166","6","27.7"
"225 IRVING AVENUE","Brooklyn","3075143","11237","304","37","0","37","6","6.2"
"1433 GREENE AVENUE","Brooklyn","3075167","11237","304","21","0","21","6","3.5"
"1431 GREENE AVENUE","Brooklyn","3075168","11237","304","57","0","57","6","9.5"
"209 ST NICHOLAS AVENUE","Brooklyn","3075229","11237","304","9","0","9","3","3"
"203 ST NICHOLAS AVENUE","Brooklyn","3075231","11237","304","21","0","21","6","3.5"
"1267 BROADWAY","Brooklyn","3075275","11221","304","24","3","27","6","4.5"
"1132 GREENE AVENUE","Brooklyn","3075327","11221","304","16","2","18","3","6"
"276 WILSON AVENUE","Brooklyn","3075395","11237","304","26","0","26","8","3.3"
"283 BLEECKER STREET","Brooklyn","3075449","11237","304","37","0","37","6","6.2"
"1422 GREENE AVENUE","Brooklyn","3075472","11237","304","67","13","80","6","13.3"
"229 WYCKOFF AVENUE","Brooklyn","3075519","11237","304","26","0","26","6","4.3"
"160 BLEEKER STREET","Brooklyn","3075647","11221","304","140","7","147","6","24.5"
"266 IRVING AVENUE","Brooklyn","3075718","11237","304","16","0","16","4","4"
"334 BLEECKER STREET","Brooklyn","3075739","11237","304","21","0","21","6","3.5"
"327 MENAHAN STREET","Brooklyn","3075764","11237","304","42","0","42","6","7"
"317 MENAHAN STREET","Brooklyn","3075769","11237","304","102","3","105","3","35"
"257 WYCKOFF AVENUE","Brooklyn","3075776","11237","304","25","0","25","3","8.3"
"428 BLEECKER STREET","Brooklyn","3075831","11237","304","25","0","25","6","4.2"
"417 MENAHAN STREET","Brooklyn","3075848","11237","304","75","0","75","6","12.5"
"69 GROVE STREET","Brooklyn","3075871","11221","304","12","0","12","3","4"
"58 MENAHAN STREET","Brooklyn","3075881","11221","304","23","0","23","5","4.6"
"1466 MYRTLE AVENUE","Brooklyn","3075916","11237","304","26","0","26","6","4.3"
"316 MENAHAN STREET","Brooklyn","3075956","11237","304","21","0","21","6","3.5"
"345 GROVE STREET","Brooklyn","3075976","11237","304","32","0","32","6","5.3"
"83 LINDEN STREET","Brooklyn","3076068","11221","304","26","0","26","8","3.3"
"316 GROVE STREET","Brooklyn","3076143","11237","304","18","0","18","6","3"
"269 LINDEN STREET","Brooklyn","3076164","11237","304","53","0","53","3","17.7"
"343 LINDEN STREET","Brooklyn","3076193","11237","304","115","3","118","12","9.8"
"291 WYCKOFF AVENUE","Brooklyn","3076197","11237","304","129","0","129","6","21.5"
"397 LINDEN STREET","Brooklyn","3076207","11237","304","33","0","33","6","5.5"
"395 LINDEN STREET","Brooklyn","3076208","11237","304","46","8","54","6","9"
"357 CENTRAL AVENUE","Brooklyn","3076284","11221","304","18","0","18","3","6"
"1337 GATES AVENUE","Brooklyn","3076295","11221","304","49","0","49","15","3.3"
"264 WYCKOFF AVENUE","Brooklyn","3076367","11237","304","9","2","11","3","3.7"
"406 LINDEN STREET","Brooklyn","3076390","11237","304","13","0","13","3","4.3"
"304 ST NICHOLAS AVENUE","Brooklyn","3076398","11237","304","21","3","24","6","4"
"1112 GATES AVENUE","Brooklyn","3076409","11221","304","19","0","19","3","6.3"
"1158 GATES AVENUE","Brooklyn","3076422","11221","304","21","0","21","6","3.5"
"1328 GATES AVENUE","Brooklyn","3076440","11221","304","59","0","59","6","9.8"
"201 PALMETTO STREET","Brooklyn","3076449","11221","304","13","0","13","3","4.3"
"187 PALMETTO STREET","Brooklyn","3076456","11221","304","25","0","25","6","4.2"
"183 PALMETTO STREET","Brooklyn","3076457","11221","304","35","0","35","6","5.8"
"120 PALMETTO STREET","Brooklyn","3076587","11221","304","18","0","18","6","3"
"260 PALMETTO STREET","Brooklyn","3076633","11221","304","9","1","10","3","3.3"
"352 PALMETTO STREET","Brooklyn","3076670","11237","304","51","0","51","6","8.5"
"14 WOODBINE STREET","Brooklyn","3076704","11221","304","16","2","18","3","6"
"1104 BUSHWICK AVENUE","Brooklyn","3076719","11221","304","54","0","54","6","9"
"339 WOODBINE STREET","Brooklyn","3076855","11237","304","14","0","14","4","3.5"
"371 IRVING AVENUE","Brooklyn","3076879","11237","304","44","0","44","8","5.5"
"386 WOODBINE STREET","Brooklyn","3076880","11237","304","19","2","21","6","3.5"
"657 KNICKERBOCKER AVENUE","Brooklyn","3076909","11221","304","48","0","48","8","6"
"1119 PUTNAM AVENUE","Brooklyn","3076947","11221","304","26","0","26","3","8.7"
"443 WILSON AVENUE","Brooklyn","3077059","11221","304","40","0","40","8","5"
"441 WILSON AVENUE","Brooklyn","3077060","11221","304","115","6","121","12","10.1"
"1392 MADISON STREET","Brooklyn","3077114","11237","304","11","0","11","3","3.7"
"1114 PUTNAM AVENUE","Brooklyn","3077137","11221","304","21","0","21","3","7"
"1116 PUTNAM AVENUE","Brooklyn","3077138","11221","304","11","0","11","3","3.7"
"1120 PUTNAM AVENUE","Brooklyn","3077140","11221","304","35","0","35","3","11.7"
"95 CORNELIA STREET","Brooklyn","3077188","11221","304","3","10","13","3","4.3"
"71 CORNELIA STREET","Brooklyn","3077200","11221","304","43","1","44","3","14.7"
"1230 PUTNAM AVENUE","Brooklyn","3077211","11221","304","56","1","57","3","19"
"1384 PUTNAM AVENUE","Brooklyn","3077292","11221","304","23","0","23","6","3.8"
"407 CORNELIA STREET","Brooklyn","3077430","11237","304","20","0","20","3","6.7"
"1505 BROADWAY","Brooklyn","3077432","11221","304","109","1","110","8","13.8"
"38 CORNELIA STREET","Brooklyn","3077449","11221","304","57","36","93","3","31"
"40 CORNELIA STREET","Brooklyn","3077450","11221","304","64","3","67","3","22.3"
"1182 BUSHWICK AVENUE","Brooklyn","3077456","11221","304","15","0","15","4","3.8"
"1055 JEFFERSON AVENUE","Brooklyn","3077467","11221","304","10","0","10","3","3.3"
"479 CENTRAL AVENUE","Brooklyn","3077575","11221","304","297","7","304","5","60.8"
"248 CORNELIA STREET","Brooklyn","3077627","11221","304","19","0","19","5","3.8"
"1218 BUSHWICK AVENUE","Brooklyn","3077815","11221","304","24","1","25","7","3.6"
"989 HANCOCK STREET","Brooklyn","3077827","11221","304","109","8","117","3","39"
"1302 JEFFERSON AVENUE","Brooklyn","3077973","11221","304","225","4","229","7","32.7"
"1392 JEFFERSON AVENUE","Brooklyn","3078042","11237","304","10","0","10","3","3.3"
"1339 HANCOCK STREET","Brooklyn","3078080","11237","304","88","0","88","6","14.7"
"1335 HANCOCK STREET","Brooklyn","3078081","11237","304","71","0","71","6","11.8"
"1323 HANCOCK STREET","Brooklyn","3078085","11237","304","32","0","32","6","5.3"
"1518 JEFFERSON AVENUE","Brooklyn","3078125","11237","304","22","5","27","6","4.5"
"1024 HANCOCK STREET","Brooklyn","3078162","11221","304","26","0","26","3","8.7"
"507 CENTRAL AVENUE","Brooklyn","3078283","11221","304","20","0","20","6","3.3"
"515 WILSON AVENUE","Brooklyn","3078335","11221","304","58","0","58","6","9.7"
"255 WEIRFIELD STREET","Brooklyn","3078373","11221","304","40","0","40","3","13.3"
"1336 HANCOCK STREET","Brooklyn","3078385","11237","304","49","1","50","6","8.3"
"552 CENTRAL AVENUE","Brooklyn","3078575","11207","304","15","0","15","4","3.8"
"1235 HALSEY STREET","Brooklyn","3078692","11237","304","45","0","45","8","5.6"
"93 ELDERT STREET","Brooklyn","3078779","11207","304","15","0","15","3","5"
"1132 HALSEY STREET","Brooklyn","3078805","11207","304","30","0","30","3","10"
"559 WILSON AVENUE","Brooklyn","3078861","11207","304","23","0","23","6","3.8"
"555 WILSON AVENUE","Brooklyn","3078863","11207","304","23","1","24","4","6"
"1242 HALSEY STREET","Brooklyn","3078876","11207","304","78","0","78","3","26"
"1246 HALSEY STREET","Brooklyn","3078878","11207","304","10","0","10","3","3.3"
"784 KNICKERBOCKER AVENUE","Brooklyn","3078882","11207","304","14","0","14","3","4.7"
"1298 HALSEY STREET","Brooklyn","3078916","11237","304","22","0","22","6","3.7"
"333 ELDERT STREET","Brooklyn","3078930","11237","304","49","0","49","4","12.3"
"35 COVERT STREET","Brooklyn","3078985","11207","304","97","2","99","6","16.5"
"194 ELDERT STREET","Brooklyn","3079029","11207","304","13","0","13","3","4.3"
"265 COVERT STREET","Brooklyn","3079087","11207","304","20","0","20","3","6.7"
"239 SCHAEFER STREET","Brooklyn","3079342","11207","304","15","0","15","3","5"
"326 COVERT STREET","Brooklyn","3079374","11237","304","20","0","20","6","3.3"
"328 COVERT STREET","Brooklyn","3079375","11237","304","23","0","23","6","3.8"
"1352 BUSHWICK AVENUE","Brooklyn","3079412","11207","304","39","0","39","3","13"
"1358 BUSHWICK AVENUE","Brooklyn","3079415","11207","304","18","0","18","6","3"
"186 SCHAEFER STREET","Brooklyn","3079494","11207","304","147","0","147","6","24.5"
"220 SCHAEFER STREET","Brooklyn","3079534","11207","304","12","0","12","3","4"
"226 SCHAEFER STREET","Brooklyn","3079538","11207","304","29","3","32","6","5.3"
"1269 DECATUR STREET","Brooklyn","3079562","11207","304","49","0","49","4","12.3"
"278 SCHAEFER STREET","Brooklyn","3079586","11237","304","38","0","38","3","12.7"
"1378 BUSHWICK AVENUE","Brooklyn","3079638","11207","304","18","0","18","3","6"
"631 WILSON AVENUE","Brooklyn","3079774","11207","304","53","0","53","6","8.8"
"225 COOPER STREET","Brooklyn","3079800","11207","304","61","0","61","5","12.2"
"18 COOPER STREET","Brooklyn","3079862","11207","304","25","0","25","3","8.3"
"1408 BUSHWICK AVENUE","Brooklyn","3079880","11207","304","32","0","32","9","3.6"
"711 EVERGREEN AVENUE","Brooklyn","3079945","11207","304","136","2","138","5","27.6"
"110 COOPER STREET","Brooklyn","3079947","11207","304","34","5","39","6","6.5"
"643 CENTRAL AVENUE","Brooklyn","3080003","11207","304","18","0","18","6","3"
"636 WILSON AVENUE","Brooklyn","3080019","11207","304","24","0","24","6","4"
"1423 BUSHWICK AVENUE","Brooklyn","3080072","11207","304","17","1","18","6","3"
"669 CENTRAL AVENUE","Brooklyn","3080150","11207","304","25","0","25","4","6.3"
"230 MOFFAT STREET","Brooklyn","3080172","11207","304","19","0","19","6","3.2"
"728 CHAUNCEY STREET","Brooklyn","3080252","11207","304","83","0","83","3","27.7"
"37 GRANITE STREET","Brooklyn","3080319","11207","304","41","0","41","6","6.8"
"27 GRANITE STREET","Brooklyn","3080321","11207","304","18","0","18","5","3.6"
"24 GRANITE STREET","Brooklyn","3080371","11207","304","29","0","29","6","4.8"
"58 DE SALES PLACE","Brooklyn","3080495","11207","304","36","0","36","6","6"
"22 MARGINAL ST WEST","Brooklyn","3080589","11207","305","20","0","20","3","6.7"
"1729 PITKIN AVENUE","Brooklyn","3080688","11212","316","19","3","22","6","3.7"
"1166 EAST NEW YORK AVENUE","Brooklyn","3080782","11212","316","15","0","15","4","3.8"
"685 RALPH AVENUE","Brooklyn","3080798","11212","316","79","0","79","4","19.8"
"2022 UNION STREET","Brooklyn","3080809","11212","316","133","2","135","4","33.8"
"2026 UNION STREET","Brooklyn","3080811","11212","316","26","0","26","4","6.5"
"2057 UNION STREET","Brooklyn","3080824","11212","316","26","0","26","4","6.5"
"620 HOWARD AVENUE","Brooklyn","3080879","11212","316","25","0","25","7","3.6"
"95 LEGION STREET","Brooklyn","3080903","11212","316","21","3","24","8","3"
"83 LEGION STREET","Brooklyn","3080906","11212","316","24","0","24","4","6"
"130 BRISTOL STREET","Brooklyn","3081018","11212","316","68","0","68","4","17"
"739 RALPH AVENUE","Brooklyn","3081160","11212","316","18","0","18","5","3.6"
"2115 UNION STREET","Brooklyn","3081183","11212","316","18","0","18","4","4.5"
"2111 UNION STREET","Brooklyn","3081184","11212","316","33","0","33","4","8.3"
"129 TAPSCOTT STREET","Brooklyn","3081209","11212","316","34","0","34","6","5.7"
"141 LEGION STREET","Brooklyn","3081286","11212","316","21","0","21","3","7"
"1968 STRAUSS STREET","Brooklyn","3081331","11212","316","83","3","86","6","14.3"
"189 DUMONT AVENUE","Brooklyn","3081741","11212","316","93","0","93","6","15.5"
"806 HOWARD AVENUE","Brooklyn","3081798","11212","316","29","0","29","6","4.8"
"231 GRAFTON STREET","Brooklyn","3081861","11212","316","0","11","11","3","3.7"
"702 ROCKAWAY AVENUE","Brooklyn","3081941","11212","316","61","0","61","18","3.4"
"348 LEGION STREET","Brooklyn","3082001","11212","316","23","0","23","4","5.8"
"313 LEGION STREET","Brooklyn","3082016","11212","316","15","2","17","4","4.3"
"311 LEGION STREET","Brooklyn","3082017","11212","316","26","0","26","4","6.5"
"307 LEGION STREET","Brooklyn","3082018","11212","316","35","0","35","4","8.8"
"813 SARATOGA AVENUE","Brooklyn","3082040","11212","316","19","0","19","4","4.8"
"801 SARATOGA AVENUE","Brooklyn","3082043","11212","316","55","3","58","4","14.5"
"77 RIVERDALE AVENUE","Brooklyn","3082069","11212","316","44","0","44","4","11"
"362 AMBOY STREET","Brooklyn","3082086","11212","316","17","0","17","4","4.3"
"411 LEGION STREET","Brooklyn","3082177","11212","316","32","0","32","4","8"
"401 LEGION STREET","Brooklyn","3082180","11212","316","11","1","12","4","3"
"367 LEGION STREET","Brooklyn","3082191","11212","316","45","0","45","4","11.3"
"365 LEGION STREET","Brooklyn","3082192","11212","316","26","0","26","4","6.5"
"867 SARATOGA AVENUE","Brooklyn","3082225","11212","316","14","0","14","3","4.7"
"2202 STRAUSS STREET","Brooklyn","3082234","11212","316","15","0","15","4","3.8"
"2253 STRAUSS STREET","Brooklyn","3082249","11212","316","30","0","30","3","10"
"438 HERZL STREET","Brooklyn","3082254","11212","316","36","0","36","4","9"
"431 HERZL STREET","Brooklyn","3082266","11212","316","18","0","18","4","4.5"
"423 HERZL STREET","Brooklyn","3082269","11212","316","14","0","14","4","3.5"
"411 HERZL STREET","Brooklyn","3082273","11212","316","18","0","18","4","4.5"
"110 RIVERDALE AVENUE","Brooklyn","3082281","11212","316","91","0","91","4","22.8"
"451 BRISTOL STREET","Brooklyn","3082369","11212","316","47","0","47","4","11.8"
"912 SARATOGA AVENUE","Brooklyn","3082397","11212","316","179","0","179","35","5.1"
"945 SARATOGA AVENUE","Brooklyn","3082401","11212","316","54","0","54","4","13.5"
"913 SARATOGA AVENUE","Brooklyn","3082412","11212","316","52","0","52","4","13"
"905 SARATOGA AVENUE","Brooklyn","3082414","11212","316","20","0","20","4","5"
"2268 STRAUSS STREET","Brooklyn","3082420","11212","316","58","0","58","4","14.5"
"2313 STRAUSS STREET","Brooklyn","3082438","11212","316","20","0","20","3","6.7"
"2293 STRAUSS STREET","Brooklyn","3082444","11212","316","43","0","43","4","10.8"
"2265 STRAUSS STREET","Brooklyn","3082454","11212","316","24","0","24","4","6"
"2259 STRAUSS STREET","Brooklyn","3082456","11212","316","29","0","29","4","7.3"
"472 HERZL STREET","Brooklyn","3082465","11212","316","0","12","12","4","3"
"45 LOTT AVENUE","Brooklyn","3082474","11212","316","47","3","50","16","3.1"
"485 HERZL STREET","Brooklyn","3082478","11212","316","59","0","59","4","14.8"
"932 HOPKINSON AVENUE","Brooklyn","3082507","11212","316","27","1","28","5","5.6"
"73 LOTT AVENUE","Brooklyn","3082510","11212","316","39","0","39","12","3.3"
"531 BRISTOL STREET","Brooklyn","3082579","11212","316","68","0","68","12","5.7"
"513 BRISTOL STREET","Brooklyn","3082585","11212","316","89","5","94","4","23.5"
"509 BRISTOL STREET","Brooklyn","3082586","11212","316","16","0","16","4","4"
"539 CHESTER STREET","Brooklyn","3082611","11212","316","27","0","27","4","6.8"
"533 CHESTER STREET","Brooklyn","3082613","11212","316","13","0","13","4","3.3"
"497 CHESTER STREET","Brooklyn","3082621","11212","316","34","0","34","6","5.7"
"2329 STRAUSS STREET","Brooklyn","3082688","11212","316","13","0","13","4","3.3"
"2327 STRAUSS STREET","Brooklyn","3082689","11212","316","42","0","42","4","10.5"
"2323 STRAUSS STREET","Brooklyn","3082690","11212","316","13","0","13","4","3.3"
"42 LOTT AVENUE","Brooklyn","3082706","11212","316","66","1","67","3","22.3"
"566 A BRISTOL STREET","Brooklyn","3082760","11212","316","52","0","52","4","13"
"580 BRISTOL STREET","Brooklyn","3082764","11212","316","42","0","42","4","10.5"
"584 BRISTOL STREET","Brooklyn","3082765","11212","316","26","7","33","4","8.3"
"602 BRISTOL STREET","Brooklyn","3082770","11212","316","19","0","19","4","4.8"
"612 CHESTER STREET","Brooklyn","3082810","11212","316","19","0","19","4","4.8"
"579 CHESTER STREET","Brooklyn","3082829","11212","316","20","0","20","4","5"
"500 THATFORD AVENUE","Brooklyn","3082854","11212","316","10","0","10","3","3.3"
"562 OSBORN STREET","Brooklyn","3082881","11212","316","25","0","25","4","6.3"
"634 OSBORN STREET","Brooklyn","3082944","11212","316","30","0","30","4","7.5"
"638 OSBORN STREET","Brooklyn","3082945","11212","316","79","0","79","4","19.8"
"637 OSBORN STREET","Brooklyn","3082965","11212","316","22","0","22","4","5.5"
"648 WATKINS STREET","Brooklyn","3082967","11212","316","17","0","17","4","4.3"
"658 WATKINS STREET","Brooklyn","3082970","11212","316","41","0","41","4","10.3"
"680 WATKINS STREET","Brooklyn","3082978","11212","316","16","0","16","4","4"
"687 WATKINS STREET","Brooklyn","3082982","11212","316","14","0","14","4","3.5"
"655 WATKINS STREET","Brooklyn","3082992","11212","316","30","0","30","4","7.5"
"653 WATKINS STREET","Brooklyn","3082993","11212","316","25","0","25","4","6.3"
"649 WATKINS STREET","Brooklyn","3082994","11212","316","42","0","42","4","10.5"
"713 BRISTOL STREET","Brooklyn","3083059","11236","316","88","0","88","4","22"
"18 WYONA STREET","Brooklyn","3083138","11207","305","10","1","11","3","3.7"
"43 SHEFFIELD AVENUE","Brooklyn","3083269","11207","305","52","5","57","6","9.5"
"37 SHEFFIELD AVENUE","Brooklyn","3083271","11207","305","75","0","75","6","12.5"
"123 VERMONT STREET","Brooklyn","3083327","11207","305","12","0","12","3","4"
"117 BRADFORD STREET","Brooklyn","3083371","11207","305","22","0","22","3","7.3"
"257 MOTHER GASTON BOULEVARD","Brooklyn","3083401","11212","316","64","7","71","8","8.9"
"251 MOTHER GASTON BOULEVARD","Brooklyn","3083403","11212","316","121","0","121","19","6.4"
"22 HINSDALE STREET","Brooklyn","3083437","11207","305","10","0","10","3","3.3"
"41 HINSDALE STREET","Brooklyn","3083443","11207","305","16","0","16","3","5.3"
"45 HINSDALE STREET","Brooklyn","3083464","11207","305","12","0","12","3","4"
"195 NEW JERSEY AVENUE","Brooklyn","3083525","11207","305","98","0","98","3","32.7"
"158 BRADFORD STREET","Brooklyn","3083567","11207","305","23","0","23","6","3.8"
"279 MOTHER GASTON BOULEVARD","Brooklyn","3083598","11212","316","12","1","13","4","3.3"
"126 LIBERTY AVENUE","Brooklyn","3083614","11212","316","32","0","32","10","3.2"
"460 GLENMORE AVENUE","Brooklyn","3083853","11207","305","71","2","73","5","14.6"
"305 WYONA STREET","Brooklyn","3083933","11207","305","129","1","130","3","43.3"
"303 WYONA STREET","Brooklyn","3083934","11207","305","54","1","55","3","18.3"
"293 WYONA STREET","Brooklyn","3083937","11207","305","9","9","18","3","6"
"2168 PITKIN AVENUE","Brooklyn","3083949","11207","305","34","0","34","3","11.3"
"2170 PITKIN AVENUE","Brooklyn","3083950","11207","305","11","0","11","3","3.7"
"356 MILLER AVENUE","Brooklyn","3083989","11207","305","34","0","34","3","11.3"
"366 MILLER AVENUE","Brooklyn","3083993","11207","305","54","0","54","3","18"
"370 NEW JERSEY AVENUE","Brooklyn","3084091","11207","305","10","0","10","3","3.3"
"382 NEW JERSEY AVENUE","Brooklyn","3084094","11207","305","10","2","12","3","4"
"301 A POWELL STREET","Brooklyn","3084227","11212","316","87","1","88","8","11"
"519 BLAKE AVENUE","Brooklyn","3084259","11207","305","72","0","72","16","4.5"
"375 SHEFFIELD AVENUE","Brooklyn","3084285","11207","305","15","0","15","5","3"
"369 SHEFFIELD AVENUE","Brooklyn","3084286","11207","305","38","0","38","4","9.5"
"418 NEW JERSEY AVENUE","Brooklyn","3084313","11207","305","88","0","88","5","17.6"
"430 NEW JERSEY AVENUE","Brooklyn","3084315","11207","305","21","0","21","3","7"
"432 NEW JERSEY AVENUE","Brooklyn","3084316","11207","305","20","0","20","3","6.7"
"425 NEW JERSEY AVENUE","Brooklyn","3084327","11207","305","18","8","26","3","8.7"
"404 BRADFORD STREET","Brooklyn","3084366","11207","305","18","0","18","3","6"
"373 BRADFORD STREET","Brooklyn","3084396","11207","305","45","0","45","4","11.3"
"444 BLAKE AVENUE","Brooklyn","3084422","11212","316","35","0","35","10","3.5"
"399 PENNSYLVANIA AVENUE","Brooklyn","3084463","11207","305","10","0","10","3","3.3"
"509 NEW JERSEY AVENUE","Brooklyn","3084488","11207","305","22","0","22","3","7.3"
"512 VERMONT STREET","Brooklyn","3084512","11207","305","11","0","11","3","3.7"
"514 VERMONT STREET","Brooklyn","3084513","11207","305","20","0","20","3","6.7"
"516 VERMONT STREET","Brooklyn","3084514","11207","305","166","0","166","4","41.5"
"715 DUMONT AVENUE","Brooklyn","3084515","11207","305","22","0","22","5","4.4"
"507 VERMONT STREET","Brooklyn","3084518","11207","305","11","0","11","3","3.7"
"440 WYONA STREET","Brooklyn","3084541","11207","305","20","0","20","3","6.7"
"470 WYONA STREET","Brooklyn","3084556","11207","305","25","0","25","3","8.3"
"725 DUMONT AVENUE","Brooklyn","3084559","11207","305","78","0","78","5","15.6"
"455 WYONA STREET","Brooklyn","3084567","11207","305","34","0","34","6","5.7"
"450 BRADFORD STREET","Brooklyn","3084580","11207","305","41","0","41","3","13.7"
"454 BRADFORD STREET","Brooklyn","3084581","11207","305","40","11","51","6","8.5"
"456 BRADFORD STREET","Brooklyn","3084582","11207","305","24","0","24","3","8"
"531 BRADFORD STREET","Brooklyn","3084773","11207","305","21","0","21","4","5.3"
"383 CHRISTOPHER AVENUE","Brooklyn","3084850","11212","316","12","0","12","4","3"
"532 WILLIAMS AVENUE","Brooklyn","3084965","11207","305","56","0","56","16","3.5"
"531 SHEFFIELD AVENUE","Brooklyn","3085043","11207","305","13","0","13","4","3.3"
"596 VERMONT STREET","Brooklyn","3085089","11207","305","73","0","73","4","18.3"
"600 VERMONT STREET","Brooklyn","3085090","11207","305","26","0","26","4","6.5"
"602 VERMONT STREET","Brooklyn","3085091","11207","305","16","0","16","4","4"
"632 VERMONT STREET","Brooklyn","3085101","11207","305","65","0","65","6","10.8"
"623 VERMONT STREET","Brooklyn","3085110","11207","305","17","0","17","3","5.7"
"588 WYONA STREET","Brooklyn","3085131","11207","305","21","0","21","6","3.5"
"603 WYONA STREET","Brooklyn","3085137","11207","305","49","0","49","12","4.1"
"599 WYONA STREET","Brooklyn","3085138","11207","305","19","0","19","4","4.8"
"557 WYONA STREET","Brooklyn","3085152","11207","305","25","0","25","4","6.3"
"564 BRADFORD STREET","Brooklyn","3085154","11207","305","258","0","258","4","64.5"
"603 BRADFORD STREET","Brooklyn","3085170","11207","305","29","0","29","3","9.7"
"640 MILLER AVENUE","Brooklyn","3085188","11207","305","63","0","63","3","21"
"529 SNEDIKER AVENUE","Brooklyn","3085365","11207","305","18","0","18","6","3"
"527 HINSDALE STREET","Brooklyn","3085394","11207","305","62","0","62","4","15.5"
"515 HINSDALE STREET","Brooklyn","3085398","11207","305","15","0","15","4","3.8"
"505 HINSDALE STREET","Brooklyn","3085400","11207","305","294","0","294","21","14"
"536 WILLIAMS AVENUE","Brooklyn","3085401","11207","305","148","0","148","22","6.7"
"552 WILLIAMS AVENUE","Brooklyn","3085403","11207","305","239","6","245","4","61.3"
"564 WILLIAMS AVENUE","Brooklyn","3085407","11207","305","44","0","44","4","11"
"578 WILLIAMS AVENUE","Brooklyn","3085412","11207","305","39","1","40","4","10"
"559 WILLIAMS AVENUE","Brooklyn","3085424","11207","305","49","0","49","4","12.3"
"547 WILLIAMS AVENUE","Brooklyn","3085428","11207","305","16","0","16","4","4"
"545 ALABAMA AVENUE","Brooklyn","3085462","11207","305","61","0","61","6","10.2"
"543 ALABAMA AVENUE","Brooklyn","3085463","11207","305","24","0","24","6","4"
"562 GEORGIA AVENUE","Brooklyn","3085469","11207","305","16","0","16","4","4"
"580 GEORGIA AVENUE","Brooklyn","3085475","11207","305","37","0","37","4","9.3"
"553 GEORGIA AVENUE","Brooklyn","3085492","11207","305","24","0","24","6","4"
"558 RIVERDALE AVENUE","Brooklyn","3085493","11207","305","21","0","21","4","5.3"
"329 NEW LOTS AVENUE","Brooklyn","3085509","11207","305","58","0","58","4","14.5"
"624 RIVERDALE AVENUE","Brooklyn","3085570","11207","305","110","11","121","6","20.2"
"660 NEW JERSEY AVENUE","Brooklyn","3085571","11207","305","13","0","13","3","4.3"
"665 NEW JERSEY AVENUE","Brooklyn","3085590","11207","305","28","0","28","4","7"
"651 VERMONT STREET","Brooklyn","3085618","11207","305","130","1","131","5","26.2"
"445 NEW LOTS AVENUE","Brooklyn","3085633","11207","305","35","0","35","4","8.8"
"690 RIVERDALE AVENUE","Brooklyn","3085639","11207","305","79","0","79","4","19.8"
"1787 LINDEN BOULEVARD","Brooklyn","3085987","11207","305","23","0","23","4","5.8"
"911 MOTHER GASTON BOULEVARD","Brooklyn","3085996","11212","316","37","0","37","4","9.3"
"891 MOTHER GASTON BOULEVARD","Brooklyn","3086002","11212","316","30","0","30","6","5"
"883 MOTHER GASTON BOULEVARD","Brooklyn","3086005","11212","316","13","0","13","4","3.3"
"708 HINSDALE STREET","Brooklyn","3086032","11207","305","21","0","21","3","7"
"733 HINSDALE STREET","Brooklyn","3086047","11207","305","38","0","38","4","9.5"
"715 HINSDALE STREET","Brooklyn","3086052","11207","305","13","0","13","3","4.3"
"55 ARLINGTON AVENUE","Brooklyn","3086822","11207","305","25","3","28","6","4.7"
"53 ARLINGTON AVENUE","Brooklyn","3086823","11207","305","79","1","80","6","13.3"
"76 WARWICK STREET","Brooklyn","3086954","11207","305","11","0","11","3","3.7"
"117 CLEVELAND STREET","Brooklyn","3087060","11208","305","0","12","12","4","3"
"2829 FULTON STREET","Brooklyn","3087516","11207","305","31","1","32","6","5.3"
"2946 FULTON STREET","Brooklyn","3087982","11207","305","20","0","20","3","6.7"
"230 HIGHLAND PLACE","Brooklyn","3088165","11208","305","22","0","22","6","3.7"
"194 HALE AVENUE","Brooklyn","3088195","11208","305","77","0","77","4","19.3"
"673 LIBERTY AVENUE","Brooklyn","3088350","11207","305","10","5","15","5","3"
"773 LIBERTY AVENUE","Brooklyn","3088435","11208","305","20","2","22","3","7.3"
"553 GLENMORE AVENUE","Brooklyn","3088508","11207","305","23","0","23","6","3.8"
"282 ASHFORD STREET","Brooklyn","3088610","11207","305","92","7","99","6","16.5"
"664 LIBERTY AVENUE","Brooklyn","3088630","11207","305","22","0","22","6","3.7"
"295 SCHENCK AVENUE","Brooklyn","3088811","11207","305","14","0","14","3","4.7"
"2349 PITKIN AVENUE","Brooklyn","3088877","11207","305","28","14","42","3","14"
"323 ASHFORD STREET","Brooklyn","3088886","11207","305","15","0","15","3","5"
"379 ELTON STREET","Brooklyn","3088943","11208","305","26","0","26","5","5.2"
"445 LINWOOD STREET","Brooklyn","3088948","11208","305","46","0","46","3","15.3"
"864 GLENMORE AVENUE","Brooklyn","3089055","11208","305","17","0","17","3","5.7"
"405 BARBEY STREET","Brooklyn","3089151","11207","305","14","0","14","3","4.7"
"428 ESSEX STREET","Brooklyn","3089259","11208","305","0","13","13","3","4.3"
"425 ESSEX STREET","Brooklyn","3089276","11208","305","20","0","20","4","5"
"209 ATKINS AVENUE","Brooklyn","3089333","11208","305","35","0","35","6","5.8"
"506 BELMONT AVENUE","Brooklyn","3089405","11207","305","99","0","99","3","33"
"425 JEROME STREET","Brooklyn","3089437","11207","305","60","0","60","4","15"
"534 CLEVELAND STREET","Brooklyn","3089506","11208","305","72","1","73","3","24.3"
"973 SUTTER AVENUE","Brooklyn","3089525","11208","305","32","0","32","5","6.4"
"816 BELMONT AVENUE","Brooklyn","3089610","11208","305","57","0","57","13","4.4"
"1101 SUTTER AVENUE","Brooklyn","3089630","11208","305","10","0","10","3","3.3"
"1123 SUTTER AVENUE","Brooklyn","3089647","11208","305","34","0","34","4","8.5"
"552 WARWICK STREET","Brooklyn","3089733","11207","305","16","1","17","4","4.3"
"551 SHEPHERD AVENUE","Brooklyn","3089845","11208","305","34","0","34","3","11.3"
"297 ATKINS AVENUE","Brooklyn","3089902","11208","305","12","1","13","4","3.3"
"311 MONTAUK AVENUE","Brooklyn","3089921","11208","305","108","8","116","6","19.3"
"309 MONTAUK AVENUE","Brooklyn","3089922","11208","305","16","0","16","3","5.3"
"305 MONTAUK AVENUE","Brooklyn","3089924","11208","305","15","0","15","3","5"
"572 ELTON STREET","Brooklyn","3090160","11208","305","14","3","17","4","4.3"
"1017 DUMONT AVENUE","Brooklyn","3090216","11208","305","23","0","23","4","5.8"
"362 MONTAUK AVENUE","Brooklyn","3090295","11208","305","11","0","11","3","3.7"
"542 VAN SICLEN AVENUE","Brooklyn","3090351","11207","305","16","1","17","4","4.3"
"651 BARBEY STREET","Brooklyn","3090424","11207","305","50","0","50","6","8.3"
"576 JEROME STREET","Brooklyn","3090434","11207","305","18","0","18","3","6"
"655 WARWICK STREET","Brooklyn","3090478","11207","305","120","0","120","6","20"
"704 CLEVELAND STREET","Brooklyn","3090550","11208","305","19","0","19","6","3.2"
"705 CLEVELAND STREET","Brooklyn","3090562","11208","305","30","0","30","3","10"
"679 CLEVELAND STREET","Brooklyn","3090569","11208","305","22","0","22","4","5.5"
"705 LINWOOD STREET","Brooklyn","3090603","11208","305","14","2","16","3","5.3"
"669 MILLER AVENUE","Brooklyn","3090638","11207","305","22","0","22","6","3.7"
"665 MILLER AVENUE","Brooklyn","3090639","11207","305","23","0","23","6","3.8"
"659 MILLER AVENUE","Brooklyn","3090641","11207","305","75","0","75","6","12.5"
"583 VAN SICLEN AVENUE","Brooklyn","3090677","11207","305","83","2","85","6","14.2"
"780 LIVONIA AVENUE","Brooklyn","3090681","11207","305","35","0","35","8","4.4"
"563 NEW LOTS AVENUE","Brooklyn","3090700","11207","305","158","3","161","3","53.7"
"36 EUCLID AVENUE","Brooklyn","3090877","11208","305","28","0","28","6","4.7"
"19 COX PLACE","Brooklyn","3090958","11208","305","72","12","84","6","14"
"114 CRESCENT STREET","Brooklyn","3091671","11208","305","22","0","22","6","3.7"
"178 NICHOLS AVENUE","Brooklyn","3091849","11208","305","9","0","9","3","3"
"575 RIDGEWOOD AVENUE","Brooklyn","3091972","11208","305","14","1","15","4","3.8"
"201 CHESTNUT STREET","Brooklyn","3092132","11208","305","190","17","207","8","25.9"
"3251 FULTON STREET","Brooklyn","3092168","11208","305","126","0","126","4","31.5"
"552 RIDGEWOOD AVENUE","Brooklyn","3092493","11208","305","9","0","9","3","3"
"187 GRANT AVENUE","Brooklyn","3092546","11208","305","12","0","12","3","4"
"223 RICHMOND STREET","Brooklyn","3092645","11208","305","13","0","13","4","3.3"
"86 FOUNTAIN AVENUE","Brooklyn","3093195","11208","305","11","0","11","3","3.7"
"31 HILL STREET","Brooklyn","3093407","11208","305","12","0","12","3","4"
"130 GLEN STREET","Brooklyn","3093471","11208","305","84","0","84","23","3.7"
"140 MC KINLEY AVENUE","Brooklyn","3093563","11208","305","18","0","18","3","6"
"435 LINCOLN AVENUE","Brooklyn","3093970","11208","305","30","0","30","6","5"
"120 SHERIDAN AVENUE","Brooklyn","3093989","11208","305","59","0","59","6","9.8"
"236 MC KINLEY AVENUE","Brooklyn","3094020","11208","305","15","0","15","4","3.8"
"418 GRANT AVENUE","Brooklyn","3094022","11208","305","15","0","15","4","3.8"
"460 GRANT AVENUE","Brooklyn","3094035","11208","305","41","0","41","6","6.8"
"466 GRANT AVENUE","Brooklyn","3094037","11208","305","32","0","32","6","5.3"
"471 GRANT AVENUE","Brooklyn","3094045","11208","305","28","0","28","4","7"
"258 MC KINLEY AVENUE","Brooklyn","3094063","11208","305","69","0","69","8","8.6"
"903 GLENMORE AVENUE","Brooklyn","3094217","11208","305","21","0","21","3","7"
"897 GLENMORE AVENUE","Brooklyn","3094218","11208","305","12","0","12","3","4"
"975 GLENMORE AVENUE","Brooklyn","3094268","11208","305","6","8","14","3","4.7"
"385 CHESTNUT STREET","Brooklyn","3094276","11208","305","64","0","64","16","4"
"1005 GLENMORE AVENUE","Brooklyn","3094284","11208","305","0","17","17","4","4.3"
"482 AUTUMN AVENUE","Brooklyn","3094338","11208","305","9","0","9","3","3"
"1097 GLENMORE AVENUE","Brooklyn","3094346","11208","305","51","1","52","6","8.7"
"493 LINCOLN AVENUE","Brooklyn","3094385","11208","305","31","0","31","3","10.3"
"481 LINCOLN AVENUE","Brooklyn","3094390","11208","305","13","0","13","3","4.3"
"189 SHERIDAN AVENUE","Brooklyn","3094422","11208","305","29","0","29","3","9.7"
"179 MILFORD STREET","Brooklyn","3094547","11208","305","180","1","181","11","16.5"
"177 MILFORD STREET","Brooklyn","3094548","11208","305","65","0","65","4","16.3"
"920 GLENMORE AVENUE","Brooklyn","3094578","11208","305","10","0","10","3","3.3"
"1120 GLENMORE AVENUE","Brooklyn","3094768","11208","305","34","0","34","6","5.7"
"1156 GLENMORE AVENUE","Brooklyn","3094793","11208","305","40","0","40","3","13.3"
"1158 GLENMORE AVENUE","Brooklyn","3094794","11208","305","71","0","71","3","23.7"
"226 FOUNTAIN AVENUE","Brooklyn","3094944","11208","305","28","0","28","3","9.3"
"2656 PITKIN AVENUE","Brooklyn","3095002","11208","305","9","0","9","3","3"
"997 BELMONT AVENUE","Brooklyn","3095054","11208","305","28","2","30","3","10"
"1021 BELMONT AVENUE","Brooklyn","3095077","11208","305","50","0","50","4","12.5"
"2718 PITKIN AVENUE","Brooklyn","3095083","11208","305","47","0","47","11","4.3"
"2736 PITKIN AVENUE","Brooklyn","3095086","11208","305","49","0","49","13","3.8"
"1059 BELMONT AVENUE","Brooklyn","3095123","11208","305","23","0","23","3","7.7"
"1089 BELMONT AVENUE","Brooklyn","3095163","11208","305","12","0","12","4","3"
"568 LINCOLN AVENUE","Brooklyn","3095200","11208","305","52","1","53","3","17.7"
"1131 SUTTER AVENUE","Brooklyn","3095282","11208","305","16","0","16","3","5.3"
"882 BELMONT AVENUE","Brooklyn","3095293","11208","305","16","0","16","4","4"
"894 BELMONT AVENUE","Brooklyn","3095298","11208","305","9","1","10","3","3.3"
"536 LOGAN STREET","Brooklyn","3095301","11208","305","15","0","15","4","3.8"
"1145 SUTTER AVENUE","Brooklyn","3095308","11208","305","27","0","27","4","6.8"
"289 FOUNTAIN AVENUE","Brooklyn","3095342","11208","305","21","0","21","6","3.5"
"930 BELMONT AVENUE","Brooklyn","3095351","11208","305","25","0","25","4","6.3"
"934 BELMONT AVENUE","Brooklyn","3095353","11208","305","13","0","13","4","3.3"
"532 EUCLID AVENUE","Brooklyn","3095412","11208","305","18","0","18","3","6"
"595 AUTUMN AVENUE","Brooklyn","3095563","11208","305","29","0","29","6","4.8"
"624 LINCOLN AVENUE","Brooklyn","3095581","11208","305","66","0","66","3","22"
"327 MILFORD STREET","Brooklyn","3095617","11208","305","30","0","30","6","5"
"317 MILFORD STREET","Brooklyn","3095619","11208","305","22","23","45","4","11.3"
"584 LOGAN STREET","Brooklyn","3095633","11208","305","185","0","185","9","20.6"
"1147 BLAKE AVENUE","Brooklyn","3095638","11208","305","17","0","17","4","4.3"
"1139 BLAKE AVENUE","Brooklyn","3095641","11208","305","46","0","46","4","11.5"
"1158 SUTTER AVENUE","Brooklyn","3095660","11208","305","36","0","36","4","9"
"1338 SUTTER AVENUE","Brooklyn","3095784","11208","305","11","0","11","3","3.7"
"670 HEMLOCK STREET","Brooklyn","3095790","11208","305","9","0","9","3","3"
"1295 BLAKE AVENUE","Brooklyn","3095803","11208","305","39","0","39","3","13"
"661 HEMLOCK STREET","Brooklyn","3095815","11208","305","49","0","49","3","16.3"
"664 AUTUMN AVENUE","Brooklyn","3095837","11208","305","10","0","10","3","3.3"
"1146 BLAKE AVENUE","Brooklyn","3095967","11208","305","36","0","36","4","9"
"648 LOGAN STREET","Brooklyn","3095972","11208","305","26","0","26","6","4.3"
"1063 NEW LOTS AVENUE","Brooklyn","3095975","11208","305","20","0","20","6","3.3"
"1258 BLAKE AVENUE","Brooklyn","3096002","11208","305","11","0","11","3","3.7"
"296 NEW LOTS AVENUE","Brooklyn","3096272","11207","305","26","0","26","5","5.2"
"645 ALABAMA AVENUE","Brooklyn","3096318","11207","305","54","1","55","4","13.8"
"686 SHEFFIELD AVENUE","Brooklyn","3096346","11207","305","10","0","10","3","3.3"
"694 PENNSYLVANIA AVENUE","Brooklyn","3096405","11207","305","51","4","55","4","13.8"
"702 PENNSYLVANIA AVENUE","Brooklyn","3096408","11207","305","17","2","19","4","4.8"
"708 PENNSYLVANIA AVENUE","Brooklyn","3096410","11207","305","18","0","18","4","4.5"
"714 PENNSYLVANIA AVENUE","Brooklyn","3096412","11207","305","23","0","23","4","5.8"
"718 PENNSYLVANIA AVENUE","Brooklyn","3096413","11207","305","20","0","20","5","4"
"683 SHEFFIELD AVENUE","Brooklyn","3096424","11207","305","32","3","35","4","8.8"
"677 SHEFFIELD AVENUE","Brooklyn","3096426","11207","305","18","0","18","3","6"
"693 PENNSYLVANIA AVENUE","Brooklyn","3096484","11207","305","15","0","15","4","3.8"
"689 PENNSYLVANIA AVENUE","Brooklyn","3096485","11207","305","11","1","12","4","3"
"653 PENNSYLVANIA AVENUE","Brooklyn","3096496","11207","305","26","0","26","4","6.5"
"721 NEW JERSEY AVENUE","Brooklyn","3096566","11207","305","20","0","20","3","6.7"
"710 WYONA STREET","Brooklyn","3096602","11207","305","38","3","41","3","13.7"
"680 BRADFORD STREET","Brooklyn","3096659","11207","305","9","0","9","3","3"
"651 WYONA STREET","Brooklyn","3096692","11207","305","20","0","20","4","5"
"700 MILLER AVENUE","Brooklyn","3096700","11207","305","104","0","104","6","17.3"
"722 MILLER AVENUE","Brooklyn","3096706","11207","305","20","0","20","6","3.3"
"730 MILLER AVENUE","Brooklyn","3096708","11207","305","14","0","14","4","3.5"
"752 MILLER AVENUE","Brooklyn","3096714","11207","305","18","2","20","4","5"
"762 MILLER AVENUE","Brooklyn","3096717","11207","305","19","0","19","6","3.2"
"661 BRADFORD STREET","Brooklyn","3096738","11207","305","9","0","9","3","3"
"753 MILLER AVENUE","Brooklyn","3096782","11207","305","65","0","65","6","10.8"
"743 MILLER AVENUE","Brooklyn","3096785","11207","305","24","0","24","6","4"
"733 MILLER AVENUE","Brooklyn","3096788","11207","305","28","0","28","6","4.7"
"725 MILLER AVENUE","Brooklyn","3096790","11207","305","32","11","43","6","7.2"
"719 MILLER AVENUE","Brooklyn","3096792","11207","305","48","2","50","6","8.3"
"697 MILLER AVENUE","Brooklyn","3096798","11207","305","41","0","41","6","6.8"
"752 HENDRIX STREET","Brooklyn","3096808","11207","305","12","0","12","3","4"
"770 HENDRIX STREET","Brooklyn","3096814","11207","305","176","0","176","4","44"
"774 HENDRIX STREET","Brooklyn","3096816","11207","305","46","0","46","4","11.5"
"602 NEW LOTS AVENUE","Brooklyn","3096842","11207","305","10","0","10","3","3.3"
"731 HEGEMAN AVENUE","Brooklyn","3096894","11207","305","67","0","67","10","6.7"
"750 CLEVELAND STREET","Brooklyn","3097015","11208","305","11","0","11","3","3.7"
"811 CLEVELAND STREET","Brooklyn","3097068","11208","305","31","3","34","6","5.7"
"700 ESSEX STREET","Brooklyn","3097089","11208","305","22","0","22","4","5.5"
"718 ESSEX STREET","Brooklyn","3097092","11208","305","15","0","15","4","3.8"
"684 SHEPHERD AVENUE","Brooklyn","3097118","11208","305","11","1","12","4","3"
"739 SHEFFIELD AVENUE","Brooklyn","3097296","11207","305","20","0","20","3","6.7"
"731 PENNSYLVANIA AVENUE","Brooklyn","3097333","11207","305","23","0","23","4","5.8"
"596 HEGEMAN AVENUE","Brooklyn","3097338","11207","305","32","0","32","4","8"
"740 WYONA STREET","Brooklyn","3097345","11207","305","19","0","19","3","6.3"
"783 VERMONT STREET","Brooklyn","3097371","11207","305","13","2","15","4","3.8"
"751 WYONA STREET","Brooklyn","3097400","11207","305","14","0","14","3","4.7"
"745 WYONA STREET","Brooklyn","3097402","11207","305","16","0","16","3","5.3"
"725 WYONA STREET","Brooklyn","3097409","11207","305","50","0","50","3","16.7"
"722 VAN SICLEN AVENUE","Brooklyn","3097443","11207","305","129","1","130","23","5.7"
"757 SCHENCK AVENUE","Brooklyn","3097514","11207","305","57","0","57","3","19"
"933 CLEVELAND STREET","Brooklyn","3097745","11208","305","11","0","11","3","3.7"
"482 BERRIMAN STREET","Brooklyn","3098323","11208","305","18","0","18","3","6"
"711 SHEPHERD AVENUE","Brooklyn","3098342","11208","305","128","5","133","4","33.3"
"461 BERRIMAN STREET","Brooklyn","3098388","11208","305","74","0","74","9","8.2"
"465 ATKINS AVENUE","Brooklyn","3098429","11208","305","17","0","17","4","4.3"
"419 MONTAUK AVENUE","Brooklyn","3098461","11208","305","53","0","53","6","8.8"
"399 MONTAUK AVENUE","Brooklyn","3098469","11208","305","14","0","14","4","3.5"
"393 MONTAUK AVENUE","Brooklyn","3098470","11208","305","63","0","63","4","15.8"
"958 CRESCENT STREET","Brooklyn","3098958","11208","305","36","0","36","3","12"
"34 EAST   95 STREET","Brooklyn","3099447","11212","317","87","0","87","4","21.8"
"36 EAST 95 STREET","Brooklyn","3099448","11212","317","77","0","77","4","19.3"
"40 EAST 95 STREET","Brooklyn","3099449","11212","317","48","0","48","4","12"
"82 EAST 95 STREET","Brooklyn","3099462","11212","317","21","0","21","4","5.3"
"69 EAST 94 STREET","Brooklyn","3099476","11212","317","36","4","40","4","10"
"26 EAST 96 STREET","Brooklyn","3099489","11212","317","28","0","28","4","7"
"69 EAST 95 STREET","Brooklyn","3099519","11212","317","13","0","13","4","3.3"
"61 EAST 95 STREET","Brooklyn","3099522","11212","317","53","0","53","4","13.3"
"48 ROCKAWAY PARKWAY","Brooklyn","3099539","11212","317","142","0","142","4","35.5"
"56 ROCKAWAY PARKWAY","Brooklyn","3099542","11212","317","122","0","122","35","3.5"
"29 ROCKAWAY PARKWAY","Brooklyn","3099576","11212","317","12","0","12","4","3"
"138 EAST   51 STREET","Brooklyn","3099645","11203","317","21","0","21","4","5.3"
"141 EAST 51 STREET","Brooklyn","3099690","11203","317","16","5","21","3","7"
"109 EAST   51 STREET","Brooklyn","3099701","11203","317","13","5","18","4","4.5"
"97 EAST   51 STREET","Brooklyn","3099704","11203","317","20","0","20","4","5"
"73 EAST   51 STREET","Brooklyn","3099711","11203","317","20","0","20","4","5"
"184 EAST 91 STREET","Brooklyn","3099803","11212","317","0","14","14","4","3.5"
"141 EAST 91 STREET","Brooklyn","3099880","11212","317","63","1","64","3","21.3"
"972 RUTLAND ROAD","Brooklyn","3099884","11212","317","41","0","41","4","10.3"
"986 RUTLAND ROAD","Brooklyn","3099890","11212","317","64","0","64","5","12.8"
"1010 RUTLAND ROAD","Brooklyn","3099935","11212","317","12","0","12","4","3"
"125 EAST   93 STREET","Brooklyn","3099982","11212","317","30","0","30","4","7.5"
"152 EAST   96 STREET","Brooklyn","3100072","11212","317","13","0","13","4","3.3"
"157 EAST   95 STREET","Brooklyn","3100086","11212","317","12","0","12","4","3"
"121 EAST 95 STREET","Brooklyn","3100098","11212","317","33","0","33","4","8.3"
"112 ROCKAWAY PARKWAY","Brooklyn","3100109","11212","317","14","0","14","4","3.5"
"143 EAST   96 STREET","Brooklyn","3100130","11212","317","96","1","97","4","24.3"
"139 EAST 96 STREET","Brooklyn","3100131","11212","317","13","0","13","4","3.3"
"109 EAST 96 STREET","Brooklyn","3100141","11212","317","59","5","64","4","16"
"155 ROCKAWAY PARKWAY","Brooklyn","3100154","11212","317","70","0","70","6","11.7"
"145 ROCKAWAY PARKWAY","Brooklyn","3100157","11212","317","120","0","120","6","20"
"119 ROCKAWAY PARKWAY","Brooklyn","3100166","11212","317","18","8","26","4","6.5"
"117 ROCKAWAY PARKWAY","Brooklyn","3100167","11212","317","44","0","44","4","11"
"115 ROCKAWAY PARKWAY","Brooklyn","3100168","11212","317","12","0","12","4","3"
"99 ROCKAWAY PARKWAY","Brooklyn","3100173","11212","317","13","1","14","4","3.5"
"166 EAST   51 STREET","Brooklyn","3100189","11203","317","113","1","114","6","19"
"196 EAST   51 STREET","Brooklyn","3100197","11203","317","14","0","14","4","3.5"
"210 EAST 51 STREET","Brooklyn","3100201","11203","317","91","0","91","37","2.5"
"136 EAST 52 STREET","Brooklyn","3100211","11203","317","77","6","83","6","13.8"
"146 EAST   52 STREET","Brooklyn","3100214","11203","317","38","0","38","6","6.3"
"151 EAST   52 STREET","Brooklyn","3100255","11203","317","17","0","17","4","4.3"
"147 EAST   52 STREET","Brooklyn","3100256","11203","317","13","0","13","4","3.3"
"87 EAST   53 STREET","Brooklyn","3100293","11203","317","114","1","115","24","4.8"
"984 WINTHROP STREET","Brooklyn","3100381","11212","317","82","0","82","39","2.1"
"236 EAST 92 STREET","Brooklyn","3100456","11212","317","141","5","146","4","36.5"
"262 EAST 92 STREET","Brooklyn","3100469","11212","317","10","0","10","3","3.3"
"1011 CLARKSON AVENUE","Brooklyn","3100473","11212","317","16","0","16","5","3.2"
"1024 WINTHROP STREET","Brooklyn","3100498","11212","317","76","0","76","3","25.3"
"1030 WINTHROP STREET","Brooklyn","3100500","11212","317","13","0","13","3","4.3"
"234 EAST 93 STREET","Brooklyn","3100517","11212","317","77","1","78","3","26"
"250 EAST 93 STREET","Brooklyn","3100522","11212","317","17","0","17","3","5.7"
"259 EAST 92 STREET","Brooklyn","3100528","11212","317","68","1","69","4","17.3"
"251 EAST 92 STREET","Brooklyn","3100530","11212","317","22","0","22","4","5.5"
"244 EAST 94 STREET","Brooklyn","3100566","11212","317","65","0","65","4","16.3"
"217 EAST 93 STREET","Brooklyn","3100592","11212","317","39","0","39","4","9.8"
"201 EAST   93 STREET","Brooklyn","3100596","11212","317","12","0","12","4","3"
"1097 CLARKSON AVENUE","Brooklyn","3100619","11212","317","39","2","41","9","4.6"
"225 EAST   94 STREET","Brooklyn","3100637","11212","317","33","0","33","4","8.3"
"204 EAST 96 STREET","Brooklyn","3100663","11212","317","54","0","54","4","13.5"
"205 EAST 95 STREET","Brooklyn","3100699","11212","317","13","0","13","4","3.3"
"201 EAST 96 STREET","Brooklyn","3100728","11212","317","12","0","12","4","3"
"763 LENOX ROAD","Brooklyn","3100815","11203","317","23","3","26","6","4.3"
"825 LENOX ROAD","Brooklyn","3100868","11203","317","18","0","18","6","3"
"835 LENOX ROAD","Brooklyn","3100905","11203","317","156","0","156","4","39"
"197 EAST   52 STREET","Brooklyn","3100912","11203","317","20","0","20","6","3.3"
"38 EAST   56 STREET","Brooklyn","3100971","11203","317","15","0","15","3","5"
"310 EAST   91 STREET","Brooklyn","3101029","11212","317","22","0","22","4","5.5"
"336 EAST 91 STREET","Brooklyn","3101038","11212","317","26","0","26","4","6.5"
"280 EAST 92 STREET","Brooklyn","3101080","11212","317","17","0","17","4","4.3"
"294 EAST 93 STREET","Brooklyn","3101133","11212","317","36","0","36","4","9"
"300 EAST 93 STREET","Brooklyn","3101135","11212","317","65","1","66","4","16.5"
"322 EAST 93 STREET","Brooklyn","3101142","11212","317","17","2","19","4","4.8"
"321 EAST 92 STREET","Brooklyn","3101158","11212","317","12","0","12","3","4"
"326 EAST   94 STREET","Brooklyn","3101173","11212","317","20","0","20","4","5"
"288 EAST   95 STREET","Brooklyn","3101187","11212","317","42","0","42","4","10.5"
"294 EAST 95 STREET","Brooklyn","3101189","11212","317","46","0","46","4","11.5"
"309 EAST 94 STREET","Brooklyn","3101195","11212","317","54","1","55","6","9.2"
"293 EAST 94 STREET","Brooklyn","3101200","11212","317","26","0","26","6","4.3"
"283 EAST   94 STREET","Brooklyn","3101203","11212","317","24","0","24","6","4"
"279 EAST 94 STREET","Brooklyn","3101204","11212","317","32","0","32","6","5.3"
"9502 KINGS HIGHWAY","Brooklyn","3101228","11212","317","220","7","227","110","2.1"
"285 EAST   95 STREET","Brooklyn","3101231","11212","317","81","12","93","4","23.3"
"320 ROCKAWAY PARKWAY","Brooklyn","3101247","11212","317","21","0","21","4","5.3"
"1119 LENOX ROAD","Brooklyn","3101252","11212","317","40","0","40","6","6.7"
"316 ROCKAWAY PARKWAY","Brooklyn","3101268","11212","317","43","0","43","4","10.8"
"296 EAST   98 STREET","Brooklyn","3101278","11212","317","15","0","15","4","3.8"
"308 EAST 98 STREET","Brooklyn","3101282","11212","317","37","0","37","4","9.3"
"319 EAST   49 STREET","Brooklyn","3101383","11203","317","12","0","12","3","4"
"804 LENOX ROAD","Brooklyn","3101399","11203","317","22","1","23","4","5.8"
"179 EAST   54 STREET","Brooklyn","3101545","11203","317","27","5","32","6","5.3"
"950 LENOX ROAD","Brooklyn","3101594","11203","317","10","0","10","3","3.3"
"46 EAST 57 STREET","Brooklyn","3101599","11203","317","67","0","67","3","22.3"
"992 LENOX ROAD","Brooklyn","3101721","11212","317","25","1","26","3","8.7"
"388 EAST 94 STREET","Brooklyn","3101797","11212","317","4","11","15","4","3.8"
"427 EAST   93 STREET","Brooklyn","3101813","11212","317","16","0","16","4","4"
"1063 WILLMOHR STREET","Brooklyn","3101833","11212","317","44","0","44","4","11"
"421 EAST 94 STREET","Brooklyn","3101834","11212","317","20","0","20","4","5"
"396 EAST   95 STREET","Brooklyn","3101842","11212","317","12","1","13","3","4.3"
"371 EAST 95 STREET","Brooklyn","3101867","11212","317","17","0","17","4","4.3"
"1118 LENOX ROAD","Brooklyn","3101879","11212","317","116","10","126","9","14"
"352 EAST 96 STREET","Brooklyn","3101880","11212","317","22","0","22","4","5.5"
"364 EAST 96 STREET","Brooklyn","3101884","11212","317","23","0","23","4","5.8"
"402 EAST 96 STREET","Brooklyn","3101895","11212","317","15","0","15","4","3.8"
"406 EAST   96 STREET","Brooklyn","3101896","11212","317","14","0","14","4","3.5"
"1124 LENOX ROAD","Brooklyn","3101903","11212","317","14","0","14","4","3.5"
"392 ROCKAWAY PARKWAY","Brooklyn","3101917","11212","317","78","1","79","4","19.8"
"397 EAST 96 STREET","Brooklyn","3101931","11212","317","19","0","19","4","4.8"
"371 EAST   96 STREET","Brooklyn","3101939","11212","317","14","0","14","4","3.5"
"386 ROCKAWAY PARKWAY","Brooklyn","3101948","11212","317","19","0","19","4","4.8"
"1152 LENOX ROAD","Brooklyn","3101953","11212","317","11","1","12","3","4"
"399 ROCKAWAY PARKWAY","Brooklyn","3101981","11212","317","17","0","17","4","4.3"
"393 ROCKAWAY PARKWAY","Brooklyn","3101983","11212","317","24","0","24","4","6"
"387 ROCKAWAY PARKWAY","Brooklyn","3101985","11212","317","27","0","27","4","6.8"
"373 ROCKAWAY PARKWAY","Brooklyn","3101990","11212","317","118","1","119","4","29.8"
"369 ROCKAWAY PARKWAY","Brooklyn","3101991","11212","317","12","0","12","4","3"
"349 ROCKAWAY PARKWAY","Brooklyn","3101998","11212","317","111","0","111","4","27.8"
"867 SCHENECTADY AVENUE","Brooklyn","3102022","11203","317","14","0","14","3","4.7"
"4821 CHURCH AVENUE","Brooklyn","3102051","11203","317","15","0","15","5","3"
"4805 CHURCH AVENUE","Brooklyn","3102056","11203","317","15","0","15","4","3.8"
"4801 CHURCH AVENUE","Brooklyn","3102057","11203","317","43","0","43","4","10.8"
"355 EAST 48 STREET","Brooklyn","3102071","11203","317","30","0","30","4","7.5"
"336 EAST 52 STREET","Brooklyn","3102170","11203","317","88","0","88","9","9.8"
"5323 CHURCH AVENUE","Brooklyn","3102259","11203","317","9","0","9","3","3"
"852 LINDEN BOULEVARD","Brooklyn","3102278","11203","317","72","0","72","8","9"
"886 LINDEN BOULEVARD","Brooklyn","3102320","11203","317","10","5","15","3","5"
"168 EAST   56 STREET","Brooklyn","3102332","11203","317","31","0","31","3","10.3"
"912 LINDEN BOULEVARD","Brooklyn","3102362","11203","317","415","0","415","16","25.9"
"128 EAST   57 STREET","Brooklyn","3102396","11203","317","0","22","22","4","5.5"
"515 EAST   91 STREET","Brooklyn","3102486","11236","317","9","1","10","3","3.3"
"505 EAST   93 STREET","Brooklyn","3102541","11212","317","21","0","21","6","3.5"
"487 EAST 93 STREET","Brooklyn","3102546","11212","317","68","0","68","5","13.6"
"441 EAST 93 STREET","Brooklyn","3102555","11212","317","22","0","22","6","3.7"
"480 EAST   94 STREET","Brooklyn","3102567","11212","317","114","5","119","6","19.8"
"476 EAST   95 STREET","Brooklyn","3102589","11212","317","33","0","33","8","4.1"
"486 EAST 95 STREET","Brooklyn","3102592","11212","317","30","1","31","4","7.8"
"499 EAST 94 STREET","Brooklyn","3102599","11212","317","4","10","14","4","3.5"
"467 EAST   94 STREET","Brooklyn","3102608","11212","317","20","0","20","4","5"
"488 EAST 96 STREET","Brooklyn","3102636","11212","317","24","0","24","4","6"
"494 EAST 96 STREET","Brooklyn","3102638","11212","317","12","0","12","4","3"
"491 EAST 95 STREET","Brooklyn","3102654","11212","317","13","1","14","3","4.7"
"465 EAST 95 STREET","Brooklyn","3102661","11212","317","26","0","26","4","6.5"
"445 EAST   95 STREET","Brooklyn","3102667","11212","317","56","0","56","4","14"
"9611 CHURCH AVENUE","Brooklyn","3102674","11212","317","39","0","39","4","9.8"
"467 EAST 96 STREET","Brooklyn","3102684","11212","317","62","0","62","3","20.7"
"441 EAST 96 STREET","Brooklyn","3102694","11212","317","44","0","44","5","8.8"
"1162 WILLMOHR STREET","Brooklyn","3102728","11212","317","18","0","18","3","6"
"428 EAST 98 STREET","Brooklyn","3102733","11212","317","73","2","75","4","18.8"
"432 EAST 98 STREET","Brooklyn","3102734","11212","317","32","1","33","4","8.3"
"440 EAST 98 STREET","Brooklyn","3102737","11212","317","19","0","19","4","4.8"
"447 EAST   48 STREET","Brooklyn","3102814","11203","317","23","5","28","3","9.3"
"458 EAST 51 STREET","Brooklyn","3102875","11203","317","123","1","124","53","2.3"
"915 UTICA AVENUE","Brooklyn","3102886","11203","317","52","1","53","5","10.6"
"378 EAST   52 STREET","Brooklyn","3102896","11203","317","53","0","53","4","13.3"
"5206 CHURCH AVENUE","Brooklyn","3102928","11203","317","45","0","45","5","9"
"352 EAST   53 STREET","Brooklyn","3102943","11203","317","9","0","9","3","3"
"383 EAST   52 STREET","Brooklyn","3102966","11203","317","19","1","20","6","3.3"
"5301 SNYDER AVENUE","Brooklyn","3102995","11203","317","124","0","124","54","2.3"
"307 EAST   54 STREET","Brooklyn","3103046","11203","317","25","5","30","6","5"
"291 EAST 54 STREET","Brooklyn","3103050","11203","317","58","0","58","6","9.7"
"192 EAST   56 STREET","Brooklyn","3103061","11203","317","282","12","294","19","15.5"
"119 EAST   59 STREET","Brooklyn","3103201","11203","317","17","0","17","4","4.3"
"109 EAST   59 STREET","Brooklyn","3103204","11203","317","33","0","33","6","5.5"
"107 EAST   59 STREET","Brooklyn","3103205","11203","317","21","0","21","6","3.5"
"103 EAST   59 STREET","Brooklyn","3103206","11203","317","20","0","20","6","3.3"
"101 EAST   59 STREET","Brooklyn","3103207","11203","317","62","1","63","6","10.5"
"563 EAST   91 STREET","Brooklyn","3103400","11236","317","34","0","34","3","11.3"
"548 EAST 93 STREET","Brooklyn","3103453","11236","317","14","0","14","3","4.7"
"593 EAST   93 STREET","Brooklyn","3103478","11236","317","19","0","19","6","3.2"
"565 EAST   93 STREET","Brooklyn","3103485","11236","317","15","0","15","4","3.8"
"561 EAST   93 STREET","Brooklyn","3103486","11236","317","17","0","17","4","4.3"
"556 EAST   94 STREET","Brooklyn","3103496","11236","317","29","1","30","6","5"
"567 EAST 94 STREET","Brooklyn","3103525","11236","317","12","0","12","3","4"
"525 EAST 95 STREET","Brooklyn","3103560","11212","317","11","1","12","4","3"
"500 EAST   49 STREET","Brooklyn","3103675","11203","317","60","0","60","4","15"
"954 UTICA AVENUE","Brooklyn","3103716","11203","317","29","0","29","5","5.8"
"964 UTICA AVENUE","Brooklyn","3103721","11203","317","15","1","16","5","3.2"
"500 EAST   51 STREET","Brooklyn","3103769","11203","317","42","0","42","4","10.5"
"522 EAST   51 STREET","Brooklyn","3103778","11203","317","35","0","35","6","5.8"
"5122 SNYDER AVENUE","Brooklyn","3103811","11203","317","87","0","87","16","5.4"
"462 EAST   52 STREET","Brooklyn","3103818","11203","317","32","0","32","6","5.3"
"486 EAST   52 STREET","Brooklyn","3103825","11203","317","20","0","20","6","3.3"
"368 EAST   55 STREET","Brooklyn","3103971","11203","317","20","0","20","3","6.7"
"382 EAST   55 STREET","Brooklyn","3103976","11203","317","17","0","17","3","5.7"
"411 EAST   54 STREET","Brooklyn","3103978","11203","317","46","0","46","6","7.7"
"572 EAST   51 STREET","Brooklyn","3104329","11203","317","12","0","12","4","3"
"1067 UTICA AVENUE","Brooklyn","3104351","11203","317","37","1","38","3","12.7"
"9422 AVENUE A","Brooklyn","3105050","11236","317","30","0","30","3","10"
"632 EAST   96 STREET","Brooklyn","3105118","11236","317","128","3","131","6","21.8"
"638 EAST   96 STREET","Brooklyn","3105120","11236","317","24","0","24","6","4"
"642 EAST   96 STREET","Brooklyn","3105121","11236","317","96","0","96","6","16"
"659 ROCKAWAY PARKWAY","Brooklyn","3105180","11236","317","19","0","19","3","6.3"
"607 EAST   53 STREET","Brooklyn","3105450","11203","317","17","0","17","3","5.7"
"5205 AVENUE D","Brooklyn","3105869","11203","317","11","0","11","3","3.7"
"470 EAST NEW YORK AVENUE","Brooklyn","3106522","11225","309","37","0","37","6","6.2"
"545 BROOKLYN AVENUE","Brooklyn","3106770","11225","309","33","0","33","5","6.6"
"568 MAPLE STREET","Brooklyn","3106809","11203","309","192","1","193","6","32.2"
"590 MAPLE STREET","Brooklyn","3106816","11203","309","101","1","102","6","17"
"602 MAPLE STREET","Brooklyn","3106820","11203","309","22","0","22","6","3.7"
"604 MAPLE STREET","Brooklyn","3106821","11203","309","32","0","32","6","5.3"
"552 ALBANY AVENUE","Brooklyn","3106827","11203","309","26","0","26","6","4.3"
"556 ALBANY AVENUE","Brooklyn","3106828","11203","309","43","0","43","6","7.2"
"567 MIDWOOD STREET","Brooklyn","3106850","11203","309","10","0","10","3","3.3"
"350 MIDWOOD STREET","Brooklyn","3106922","11225","309","20","0","20","6","3.3"
"356 MIDWOOD STREET","Brooklyn","3106924","11225","309","13","0","13","4","3.3"
"470 MIDWOOD STREET","Brooklyn","3106990","11225","309","62","2","64","3","21.3"
"564 KINGSTON AVENUE","Brooklyn","3107011","11203","309","45","1","46","3","15.3"
"322 HAWTHORNE STREET","Brooklyn","3107399","11225","309","16","0","16","3","5.3"
"406 HAWTHORNE STREET","Brooklyn","3107449","11203","309","8","1","9","3","3"
"697 WINTHROP STREET","Brooklyn","3107496","11203","309","19","0","19","3","6.3"
"671 WINTHROP STREET","Brooklyn","3107504","11203","309","8","3","11","3","3.7"
"252 EAST   46 STREET","Brooklyn","3107994","11203","317","11","0","11","3","3.7"
"259 EAST   46 STREET","Brooklyn","3108043","11203","317","22","0","22","6","3.7"
"1361 NOSTRAND AVENUE","Brooklyn","3108052","11226","317","65","0","65","6","10.8"
"1363 NOSTRAND AVENUE","Brooklyn","3108054","11226","317","46","0","46","6","7.7"
"261 LINDEN BOULEVARD","Brooklyn","3108082","11226","317","22","1","23","6","3.8"
"824 ALBANY AVENUE","Brooklyn","3108274","11203","317","95","0","95","16","5.9"
"541 LINDEN BOULEVARD","Brooklyn","3108315","11203","317","36","0","36","3","12"
"56 EAST   43 STREET","Brooklyn","3108333","11203","317","12","0","12","4","3"
"651 LINDEN BOULEVARD","Brooklyn","3108484","11203","317","11","0","11","3","3.7"
"362 LINDEN BOULEVARD","Brooklyn","3108655","11203","317","98","0","98","42","2.3"
"189 EAST 34 STREET","Brooklyn","3108694","11203","317","180","0","180","70","2.6"
"3505 CHURCH AVENUE","Brooklyn","3108726","11203","317","18","2","20","6","3.3"
"880 TROY AVENUE","Brooklyn","3109074","11203","317","28","1","29","4","7.3"
"4525 CHURCH AVENUE","Brooklyn","3109165","11203","317","35","0","35","4","8.8"
"862 SCHENECTADY AVENUE","Brooklyn","3109210","11203","317","89","1","90","12","7.5"
"4623 CHURCH AVENUE","Brooklyn","3109214","11203","317","11","0","11","3","3.7"
"4621 CHURCH AVENUE","Brooklyn","3109215","11203","317","23","0","23","3","7.7"
"385 EAST   46 STREET","Brooklyn","3109228","11203","317","53","2","55","6","9.2"
"3321 SNYDER AVENUE","Brooklyn","3109394","11203","317","17","0","17","3","5.7"
"454 EAST   46 STREET","Brooklyn","3109912","11203","317","24","0","24","4","6"
"447 EAST   45 STREET","Brooklyn","3109928","11203","317","74","0","74","6","12.3"
"439 EAST   45 STREET","Brooklyn","3109929","11203","317","94","0","94","6","15.7"
"363 EAST   34 STREET","Brooklyn","3110180","11203","317","30","0","30","6","5"
"329 EAST 34 STREET","Brooklyn","3110190","11203","317","36","1","37","6","6.2"
"1633 NOSTRAND AVENUE","Brooklyn","3110414","11226","317","30","0","30","6","5"
"1076 NEW YORK AVENUE","Brooklyn","3110482","11203","317","174","0","174","59","2.9"
"1122 NEW YORK AVENUE","Brooklyn","3110485","11203","317","184","0","184","24","7.7"
"1715 NOSTRAND AVENUE","Brooklyn","3110686","11226","317","22","0","22","3","7.3"
"3012 CORTELYOU ROAD","Brooklyn","3110690","11226","317","25","0","25","3","8.3"
"1141 NEW YORK AVENUE","Brooklyn","3110805","11203","317","130","0","130","59","2.2"
"3410 BEVERLY ROAD","Brooklyn","3110847","11203","317","15","0","15","4","3.8"
"426 EAST   35 STREET","Brooklyn","3110862","11203","317","14","0","14","4","3.5"
"3015 AVENUE D","Brooklyn","3111279","11226","317","34","0","34","6","5.7"
"1825 NOSTRAND AVENUE","Brooklyn","3111282","11226","317","26","0","26","6","4.3"
"1771 NOSTRAND AVENUE","Brooklyn","3111299","11226","317","48","0","48","4","12"
"531 EAST 35 STREET","Brooklyn","3111576","11203","317","73","0","73","3","24.3"
"1354 TROY AVENUE","Brooklyn","3112924","11203","317","19","0","19","3","6.3"
"4512 AVENUE D","Brooklyn","3112998","11203","317","9","0","9","3","3"
"666 EAST   43 STREET","Brooklyn","3113401","11203","317","14","0","14","4","3.5"
"1445 TROY AVENUE","Brooklyn","3113605","11203","317","32","1","33","4","8.3"
"2077 NOSTRAND AVENUE","Brooklyn","3113952","11210","317","3","9","12","4","3"
"670 EAST 32 STREET","Brooklyn","3114020","11210","317","66","5","71","3","23.7"
"768 EAST 35 STREET","Brooklyn","3114131","11210","317","24","0","24","3","8"
"65 OCEAN AVENUE","Brooklyn","3114554","11225","309","175","0","175","41","4.3"
"606 FLATBUSH AVENUE","Brooklyn","3114609","11225","309","32","0","32","7","4.6"
"275 OCEAN AVENUE","Brooklyn","3114667","11225","309","79","2","81","21","3.9"
"483 ROGERS AVENUE","Brooklyn","3114992","11225","309","50","11","61","6","10.2"
"1116 NOSTRAND AVENUE","Brooklyn","3115015","11225","309","10","0","10","3","3.3"
"1150 NOSTRAND AVENUE","Brooklyn","3115260","11225","309","20","0","20","4","5"
"619 FLATBUSH AVENUE","Brooklyn","3115281","11225","309","70","0","70","9","7.8"
"609 FLATBUSH AVENUE","Brooklyn","3115284","11225","309","42","0","42","14","3"
"607 FLATBUSH AVENUE","Brooklyn","3115285","11225","309","102","3","105","8","13.1"
"599 FLATBUSH AVENUE","Brooklyn","3115286","11225","309","85","3","88","11","8"
"1170 NOSTRAND AVENUE","Brooklyn","3115472","11225","309","25","0","25","6","4.2"
"1176 NOSTRAND AVENUE","Brooklyn","3115474","11225","309","30","2","32","7","4.6"
"647 FLATBUSH AVENUE","Brooklyn","3115494","11225","309","28","7","35","8","4.4"
"22 HAWTHORNE STREET","Brooklyn","3115656","11225","309","107","11","118","10","11.8"
"42 HAWTHORNE STREET","Brooklyn","3115662","11225","309","43","0","43","9","4.8"
"292 HAWTHORNE STREET","Brooklyn","3115751","11225","309","25","0","25","7","3.6"
"56 WINTHROP STREET","Brooklyn","3115811","11225","309","94","2","96","9","10.7"
"1989 BEDFORD AVENUE","Brooklyn","3115848","11225","309","86","0","86","7","12.3"
"116 WINTHROP STREET","Brooklyn","3115852","11225","309","30","0","30","8","3.8"
"605 ROGERS AVENUE","Brooklyn","3115876","11225","309","13","4","17","4","4.3"
"738 FLATBUSH AVENUE","Brooklyn","3115931","11226","314","19","6","25","7","3.6"
"735 FLATBUSH AVENUE","Brooklyn","3115942","11226","309","18","0","18","4","4.5"
"655 ROGERS AVENUE","Brooklyn","3116045","11226","309","10","0","10","3","3.3"
"645 ROGERS AVENUE","Brooklyn","3116049","11226","309","39","0","39","3","13"
"287 CLARKSON AVENUE","Brooklyn","3116067","11226","309","45","0","45","8","5.6"
"80 WOODRUFF AVENUE","Brooklyn","3116104","11226","314","289","0","289","42","6.9"
"92 WOODRUFF AVENUE","Brooklyn","3116105","11226","314","67","0","67","16","4.2"
"20 CROOKE AVENUE","Brooklyn","3116112","11226","314","180","4","184","58","3.2"
"365 OCEAN AVENUE","Brooklyn","3116139","11226","314","53","0","53","16","3.3"
"43 EAST 21 STREET","Brooklyn","3116155","11226","314","414","31","445","60","7.4"
"22 CLARKSON AVENUE","Brooklyn","3116196","11226","314","31","5","36","8","4.5"
"74 CLARKSON AVENUE","Brooklyn","3116206","11226","314","227","5","232","83","2.8"
"198 CLARKSON AVENUE","Brooklyn","3116237","11226","317","107","0","107","6","17.8"
"682 ROGERS AVENUE","Brooklyn","3116241","11226","317","24","0","24","6","4"
"167 LENOX ROAD","Brooklyn","3116250","11226","317","92","0","92","39","2.4"
"10 EAST 12 STREET","Brooklyn","3116368","11218","314","89","1","90","21","4.3"
"1201 CHURCH AVENUE","Brooklyn","3116402","11218","314","33","0","33","4","8.3"
"1801 CHURCH AVENUE","Brooklyn","3116523","11226","314","12","0","12","4","3"
"156 EAST   21 STREET","Brooklyn","3116556","11226","314","81","3","84","38","2.2"
"447 OCEAN AVENUE","Brooklyn","3116562","11226","314","89","1","90","39","2.3"
"91 EAST   21 STREET","Brooklyn","3116599","11226","314","183","1","184","16","11.5"
"78 LENOX ROAD","Brooklyn","3116615","11226","314","94","0","94","47","2"
"5 LINDEN BOULEVARD","Brooklyn","3116636","11226","314","41","0","41","12","3.4"
"114 LENOX ROAD","Brooklyn","3116644","11226","317","174","6","180","82","2.2"
"50 LINDEN BOULEVARD","Brooklyn","3116710","11226","314","88","2","90","16","5.6"
"2148 BEDFORD AVENUE","Brooklyn","3116715","11226","314","95","3","98","46","2.1"
"1398 NOSTRAND AVENUE","Brooklyn","3116823","11226","317","36","1","37","4","9.3"
"267 MARTENSE STREET","Brooklyn","3116832","11226","317","10","0","10","3","3.3"
"227 MARTENSE STREET","Brooklyn","3116843","11226","317","13","0","13","4","3.3"
"2555 CHURCH AVENUE","Brooklyn","3116921","11226","317","23","0","23","6","3.8"
"2553 CHURCH AVENUE","Brooklyn","3116922","11226","317","37","0","37","6","6.2"
"2537 CHURCH AVENUE","Brooklyn","3116926","11226","317","33","0","33","8","4.1"
"2831 CHURCH AVENUE","Brooklyn","3116989","11226","317","18","0","18","4","4.5"
"11 TENNIS COURT","Brooklyn","3117101","11226","314","147","7","154","60","2.6"
"95 EAST 18 STREET","Brooklyn","3117103","11226","314","92","0","92","16","5.8"
"91 EAST   18 STREET","Brooklyn","3117104","11226","314","107","0","107","16","6.7"
"50 EAST 19 STREET","Brooklyn","3117107","11226","314","115","0","115","54","2.1"
"534 OCEAN AVENUE","Brooklyn","3117117","11226","314","75","0","75","20","3.8"
"564 OCEAN AVENUE","Brooklyn","3117119","11226","314","200","0","200","59","3.4"
"612 OCEAN AVENUE","Brooklyn","3117131","11226","314","167","4","171","80","2.1"
"2728 CHURCH AVENUE","Brooklyn","3117262","11226","317","110","0","110","10","11"
"135 ERASMUS STREET","Brooklyn","3117284","11226","317","68","0","68","8","8.5"
"236 EAST 16 STREET","Brooklyn","3117558","11226","314","133","0","133","40","3.3"
"217 EAST 16 STREET","Brooklyn","3117576","11226","314","54","0","54","16","3.4"
"1809 BEVERLY ROAD","Brooklyn","3117601","11226","314","78","0","78","9","8.7"
"229 EAST 18 STREET","Brooklyn","3117604","11226","314","390","9","399","53","7.5"
"151 EAST 19 STREET","Brooklyn","3117616","11226","314","294","0","294","107","2.7"
"119 EAST 19 STREET","Brooklyn","3117618","11226","314","136","0","136","55","2.5"
"2107 BEVERLY ROAD","Brooklyn","3117664","11226","314","133","1","134","17","7.9"
"369 EAST 21 STREET","Brooklyn","3117666","11226","314","19","0","19","5","3.8"
"363 EAST 21 STREET","Brooklyn","3117668","11226","314","24","0","24","8","3"
"2296 BEDFORD AVENUE","Brooklyn","3117684","11226","314","13","0","13","3","4.3"
"2297 BEDFORD AVENUE","Brooklyn","3117757","11226","317","8","4","12","3","4"
"2501 TILDEN AVENUE","Brooklyn","3117781","11226","317","19","0","19","3","6.3"
"2340 TILDEN AVENUE","Brooklyn","3117894","11226","317","19","1","20","6","3.3"
"2409 BEVERLY ROAD","Brooklyn","3117904","11226","317","90","13","103","3","34.3"
"985 ROGERS AVENUE","Brooklyn","3118019","11226","317","34","0","34","3","11.3"
"2815 BEVERLY ROAD","Brooklyn","3118058","11226","317","164","4","168","64","2.6"
"1656 NOSTRAND AVENUE","Brooklyn","3118098","11226","317","29","0","29","3","9.7"
"705 CONEY ISLAND AVENUE","Brooklyn","3118208","11218","314","48","0","48","6","8"
"597 CONEY ISLAND AVENUE","Brooklyn","3118228","11218","314","16","0","16","4","4"
"1802 BEVERLY ROAD","Brooklyn","3118506","11226","314","78","2","80","25","3.2"
"781 OCEAN AVENUE","Brooklyn","3118549","11226","314","71","2","73","24","3"
"739 OCEAN AVENUE","Brooklyn","3118550","11226","314","285","1","286","95","3"
"380 EAST 14 STREET","Brooklyn","3118659","11226","314","24","3","27","6","4.5"
"1502 CORTELYOU ROAD","Brooklyn","3118708","11226","314","24","0","24","3","8"
"810 OCEAN AVENUE","Brooklyn","3118798","11226","314","73","0","73","13","5.6"
"339 EAST 19 STREET","Brooklyn","3118806","11226","314","73","0","73","35","2.1"
"2128 BEVERLY ROAD","Brooklyn","3118863","11226","314","58","0","58","6","9.7"
"1077 FLATBUSH AVENUE","Brooklyn","3118906","11226","314","14","0","14","4","3.5"
"2224 CORTELYOU ROAD","Brooklyn","3118923","11226","314","28","0","28","8","3.5"
"2415 CLARENDON ROAD","Brooklyn","3119021","11226","317","115","0","115","5","23"
"2409 CLARENDON ROAD","Brooklyn","3119024","11226","317","11","0","11","3","3.7"
"1060 ROGERS AVENUE","Brooklyn","3119108","11226","317","15","0","15","5","3"
"1064 ROGERS AVENUE","Brooklyn","3119110","11226","317","25","1","26","6","4.3"
"1049 ROGERS AVENUE","Brooklyn","3119171","11226","317","89","0","89","6","14.8"
"1678 NOSTRAND AVENUE","Brooklyn","3119216","11226","317","25","0","25","4","6.3"
"1154 FLATBUSH AVENUE","Brooklyn","3119599","11226","314","59","2","61","4","15.3"
"2502 BEDFORD AVENUE","Brooklyn","3119672","11226","314","280","6","286","24","11.9"
"2303 AVENUE D","Brooklyn","3119691","11226","314","115","1","116","8","14.5"
"2408 CLARENDON ROAD","Brooklyn","3119709","11226","317","49","0","49","16","3.1"
"2575 BEDFORD AVENUE","Brooklyn","3119746","11226","317","76","0","76","3","25.3"
"2519 BEDFORD AVENUE","Brooklyn","3119761","11226","317","15","0","15","3","5"
"2499 BEDFORD AVENUE","Brooklyn","3119766","11226","317","270","5","275","48","5.7"
"2501 AVENUE D","Brooklyn","3119812","11226","317","22","0","22","3","7.3"
"301 EAST 26 STREET","Brooklyn","3119841","11226","317","119","6","125","4","31.3"
"1138 ROGERS AVENUE","Brooklyn","3119855","11226","317","25","0","25","3","8.3"
"2601 AVENUE D","Brooklyn","3119878","11226","317","11","0","11","3","3.7"
"305 EAST 26 STREET","Brooklyn","3119907","11226","317","97","0","97","4","24.3"
"366 EAST 28 STREET","Brooklyn","3119928","11226","317","18","0","18","3","6"
"1143 ROGERS AVENUE","Brooklyn","3119950","11226","317","32","4","36","3","12"
"1139 ROGERS AVENUE","Brooklyn","3119952","11226","317","24","0","24","3","8"
"2802 CLARENDON ROAD","Brooklyn","3119966","11226","317","193","0","193","38","5.1"
"2908 CLARENDON ROAD","Brooklyn","3120016","11226","317","23","0","23","6","3.8"
"1754 NOSTRAND AVENUE","Brooklyn","3120021","11226","317","28","0","28","3","9.3"
"1780 NOSTRAND AVENUE","Brooklyn","3120032","11226","317","25","0","25","3","8.3"
"1796 NOSTRAND AVENUE","Brooklyn","3120040","11226","317","16","0","16","5","3.2"
"1814 NOSTRAND AVENUE","Brooklyn","3120044","11226","317","31","0","31","4","7.8"
"967 OCEAN AVENUE","Brooklyn","3120263","11226","314","94","3","97","28","3.5"
"2323 NEWKIRK AVENUE","Brooklyn","3120306","11226","314","86","1","87","16","5.4"
"2588 BEDFORD AVENUE","Brooklyn","3120327","11226","314","2","8","10","3","3.3"
"1323 FLATBUSH AVENUE","Brooklyn","3120363","11226","317","38","0","38","4","9.5"
"2522 NEWKIRK AVENUE","Brooklyn","3120379","11226","317","123","0","123","16","7.7"
"1216 ROGERS AVENUE","Brooklyn","3120402","11226","317","24","0","24","6","4"
"2615 NEWKIRK AVENUE","Brooklyn","3120405","11226","317","38","0","38","8","4.8"
"1193 ROGERS AVENUE","Brooklyn","3120434","11226","317","212","0","212","6","35.3"
"1203 ROGERS AVENUE","Brooklyn","3120449","11226","317","30","0","30","6","5"
"412 EAST 29 STREET","Brooklyn","3120483","11226","317","34","0","34","3","11.3"
"1021 OCEAN AVENUE","Brooklyn","3120598","11226","314","48","0","48","16","3"
"2117 FOSTER AVENUE","Brooklyn","3120627","11210","314","57","0","57","13","4.4"
"1276 FLATBUSH AVENUE","Brooklyn","3120774","11226","314","25","0","25","5","5"
"570 EAST   26 STREET","Brooklyn","3120823","11210","314","95","0","95","27","3.5"
"572 EAST 26 STREET","Brooklyn","3120824","11210","314","84","0","84","8","10.5"
"567 EAST   26 STREET","Brooklyn","3120832","11210","314","73","0","73","21","3.5"
"1387 FLATBUSH AVENUE","Brooklyn","3120883","11210","314","58","0","58","3","19.3"
"525 EAST 26 STREET","Brooklyn","3120891","11210","314","20","0","20","3","6.7"
"1300 ROGERS AVENUE","Brooklyn","3120905","11210","314","25","0","25","3","8.3"
"1964 NOSTRAND AVENUE","Brooklyn","3121057","11210","314","106","0","106","53","2"
"604 EAST   14 STREET","Brooklyn","3121113","11230","314","44","0","44","3","14.7"
"630 EAST   15 STREET","Brooklyn","3121157","11226","314","29","0","29","8","3.6"
"620 EAST   17 STREET","Brooklyn","3121212","11226","314","20","0","20","6","3.3"
"1111 OCEAN AVENUE","Brooklyn","3121398","11230","314","262","162","424","102","4.2"
"36 KENILWORTH PLACE","Brooklyn","3121601","11210","314","117","2","119","43","2.8"
"685 EAST 29 STREET","Brooklyn","3121702","11210","314","17","0","17","3","5.7"
"2026 NOSTRAND AVENUE","Brooklyn","3121727","11210","314","62","1","63","11","5.7"
"1003 39 STREET","Brooklyn","3122940","11219","312","15","0","15","3","5"
"1143 39 STREET","Brooklyn","3122966","11218","312","54","1","55","6","9.2"
"1135 38 STREET","Brooklyn","3123024","11218","312","45","3","48","6","8"
"1228 39 STREET","Brooklyn","3123066","11218","312","33","0","33","3","11"
"1252 36 STREET","Brooklyn","3123189","11218","312","21","0","21","4","5.3"
"1364 40 STREET","Brooklyn","3123251","11218","312","12","0","12","4","3"
"1370 40 STREET","Brooklyn","3123253","11218","312","21","1","22","6","3.7"
"1319 41 STREET","Brooklyn","3123288","11218","312","26","1","27","6","4.5"
"1257 36 STREET","Brooklyn","3123739","11218","312","90","0","90","6","15"
"1249 36 STREET","Brooklyn","3123742","11218","312","24","1","25","6","4.2"
"102 CHESTER AVENUE","Brooklyn","3123813","11218","312","15","0","15","4","3.8"
"106 CHESTER AVENUE","Brooklyn","3123814","11218","312","16","0","16","4","4"
"25 LOUISA STREET","Brooklyn","3123954","11218","312","31","0","31","6","5.2"
"2916 FT HAMILTON PARKWAY","Brooklyn","3123977","11218","307","30","0","30","4","7.5"
"181 EAST    5 STREET","Brooklyn","3124026","11218","307","9","0","9","3","3"
"235 EAST 2 STREET","Brooklyn","3124178","11218","312","67","0","67","20","3.4"
"717 FRIEL PLACE","Brooklyn","3124361","11218","312","18","0","18","4","4.5"
"114 ALBEMARLE ROAD","Brooklyn","3124505","11218","312","137","4","141","65","2.2"
"296 EAST 2 STREET","Brooklyn","3124515","11218","312","18","0","18","6","3"
"292 EAST 3 STREET","Brooklyn","3124546","11218","312","10","0","10","3","3.3"
"1462 40 STREET","Brooklyn","3124901","11218","312","20","0","20","5","4"
"1407 35 STREET","Brooklyn","3125150","11218","312","18","0","18","6","3"
"3419 14 AVENUE","Brooklyn","3125152","11218","312","18","0","18","4","4.5"
"524 MC DONALD AVENUE","Brooklyn","3125166","11218","312","58","2","60","6","10"
"534 MC DONALD AVENUE","Brooklyn","3125169","11218","312","21","0","21","6","3.5"
"553 MC DONALD AVENUE","Brooklyn","3125271","11218","312","50","1","51","6","8.5"
"483 MC DONALD AVENUE","Brooklyn","3125295","11218","312","10","3","13","4","3.3"
"730 BEVERLY ROAD","Brooklyn","3125512","11218","312","71","1","72","3","24"
"1532 38 STREET","Brooklyn","3125846","11218","312","16","0","16","4","4"
"3623 15 AVENUE","Brooklyn","3125914","11218","312","116","0","116","6","19.3"
"3619 15 AVENUE","Brooklyn","3125915","11218","312","79","1","80","6","13.3"
"3617 15 AVENUE","Brooklyn","3125916","11218","312","21","0","21","6","3.5"
"326 EAST 9 STREET","Brooklyn","3126270","11218","312","22","0","22","4","5.5"
"124 CORTELYOU ROAD","Brooklyn","3126579","11218","312","49","0","49","6","8.2"
"309 DITMAS AVENUE","Brooklyn","3126704","11218","312","60","0","60","3","20"
"305 DITMAS AVENUE","Brooklyn","3126705","11218","312","100","1","101","3","33.7"
"543 EAST 9TH ST","Brooklyn","3127358","11218","312","11","0","11","3","3.7"
"4229 18 AVENUE","Brooklyn","3127667","11218","314","90","4","94","36","2.6"
"3813 18 AVENUE","Brooklyn","3127735","11218","314","149","0","149","31","4.8"
"294 WEBSTER AVENUE","Brooklyn","3127838","11230","314","83","0","83","38","2.2"
"312 WEBSTER AVENUE","Brooklyn","3127839","11230","314","85","0","85","38","2.2"
"84 LAWRENCE AVENUE","Brooklyn","3127878","11230","314","244","1","245","35","7"
"190 LAWRENCE AVENUE","Brooklyn","3127905","11230","314","85","0","85","6","14.2"
"1958 50 STREET","Brooklyn","3129522","11204","312","100","1","101","42","2.4"
"5516 16 AVENUE","Brooklyn","3130640","11204","312","29","0","29","5","5.8"
"1763 60 STREET","Brooklyn","3131792","11204","312","15","0","15","4","3.8"
"1735 62 STREET","Brooklyn","3132447","11204","311","51","0","51","4","12.8"
"1744 62 STREET","Brooklyn","3132751","11204","311","13","0","13","4","3.3"
"1773 63 STREET","Brooklyn","3132771","11204","311","21","0","21","4","5.3"
"6209 18 AVENUE","Brooklyn","3132799","11204","311","14","0","14","4","3.5"
"1664 64 STREET","Brooklyn","3133447","11204","311","12","0","12","4","3"
"1641 65 STREET","Brooklyn","3133464","11204","311","105","6","111","46","2.4"
"1621 65 STREET","Brooklyn","3133465","11204","311","106","5","111","46","2.4"
"1521 66 STREET","Brooklyn","3133745","11219","311","10","0","10","3","3.3"
"1673 66 STREET","Brooklyn","3133803","11204","311","23","0","23","4","5.8"
"6521 20 AVENUE","Brooklyn","3133998","11204","311","24","0","24","4","6"
"6517 20 AVENUE","Brooklyn","3133999","11204","311","81","0","81","4","20.3"
"6702 21 AVENUE","Brooklyn","3134762","11204","311","15","0","15","4","3.8"
"1115 40 STREET","Brooklyn","3135338","11218","312","37","1","38","5","7.6"
"4019 10 AVENUE","Brooklyn","3135384","11219","312","79","31","110","4","27.5"
"931 42 STREET","Brooklyn","3135567","11219","312","27","0","27","5","5.4"
"913 42 STREET","Brooklyn","3135574","11219","312","12","18","30","6","5"
"4213 FT HAMILTON PARKWAY","Brooklyn","3135829","11219","312","28","0","28","3","9.3"
"1142 42 STREET","Brooklyn","3135844","11219","312","167","2","169","16","10.6"
"4220 15 AVENUE","Brooklyn","3135988","11219","312","23","6","29","8","3.6"
"1312 43 STREET","Brooklyn","3136180","11219","312","49","0","49","3","16.3"
"1369 44 STREET","Brooklyn","3136212","11219","312","21","0","21","6","3.5"
"1472 43 STREET","Brooklyn","3136250","11219","312","98","0","98","39","2.5"
"1453 44 STREET","Brooklyn","3136268","11219","312","21","0","21","6","3.5"
"4507 10 AVENUE","Brooklyn","3136614","11219","312","21","0","21","5","4.2"
"4601 14 AVENUE","Brooklyn","3137021","11219","312","0","20","20","3","6.7"
"902 47 STREET","Brooklyn","3137062","11219","312","179","3","182","42","4.3"
"4909 12 AVENUE","Brooklyn","3137710","11219","312","32","0","32","4","8"
"1016 50 STREET","Brooklyn","3137933","11219","312","148","3","151","43","3.5"
"833 53 STREET","Brooklyn","3138496","11220","312","13","0","13","4","3.3"
"1257 55 STREET","Brooklyn","3139385","11219","312","21","1","22","5","4.4"
"1015 56 STREET","Brooklyn","3139611","11219","312","36","0","36","7","5.1"
"1140 58 STREET","Brooklyn","3140651","11219","312","102","1","103","4","25.8"
"1016 59 STREET","Brooklyn","3140944","11219","312","16","0","16","4","4"
"6211 8 AVENUE","Brooklyn","3141393","11220","310","49","0","49","6","8.2"
"6302 11 AVENUE","Brooklyn","3141741","11219","310","49","0","49","5","9.8"
"1045 64 STREET","Brooklyn","3141758","11219","310","51","0","51","12","4.3"
"1366 63 STREET","Brooklyn","3141846","11219","310","14","0","14","4","3.5"
"1005 65 STREET","Brooklyn","3141987","11219","310","15","0","15","3","5"
"1361 65 STREET","Brooklyn","3142072","11219","310","22","0","22","6","3.7"
"6502 11 AVENUE","Brooklyn","3142178","11219","310","25","6","31","4","7.8"
"1166 65 STREET","Brooklyn","3142228","11219","310","9","0","9","3","3"
"6623 FT HAMILTON PARKWAY","Brooklyn","3142359","11219","310","502","2","504","28","18"
"6601 FT HAMILTON PARKWAY","Brooklyn","3142365","11219","310","36","0","36","5","7.2"
"6608 12 AVENUE","Brooklyn","3142466","11219","310","18","0","18","3","6"
"6713 8 AVENUE","Brooklyn","3142640","11220","310","27","0","27","6","4.5"
"6710 13 AVENUE","Brooklyn","3142863","11219","310","17","0","17","5","3.4"
"845 BAY RIDGE AVENUE","Brooklyn","3143019","11220","310","35","1","36","5","7.2"
"1302 OVINGTON AVE","Brooklyn","3143216","11219","310","61","0","61","13","4.7"
"426 60 STREET","Brooklyn","3143420","11220","307","17","0","17","3","5.7"
"438 60 STREET","Brooklyn","3143425","11220","307","37","0","37","6","6.2"
"459 61 STREET","Brooklyn","3143451","11220","307","59","0","59","16","3.7"
"6023 5 AVENUE","Brooklyn","3143463","11220","307","143","0","143","6","23.8"
"6005 5 AVENUE","Brooklyn","3143470","11220","307","30","0","30","4","7.5"
"714 60 STREET","Brooklyn","3143590","11220","307","55","0","55","6","9.2"
"206 61 STREET","Brooklyn","3143619","11220","307","16","0","16","4","4"
"273 62 STREET","Brooklyn","3143657","11220","307","30","2","32","6","5.3"
"6114 4 AVENUE","Brooklyn","3143694","11220","307","70","0","70","3","23.3"
"426 61 STREET","Brooklyn","3143727","11220","307","439","0","439","17","25.8"
"6124 5 AVENUE","Brooklyn","3143741","11220","307","32","2","34","6","5.7"
"417 63 STREET","Brooklyn","3143995","11220","307","16","0","16","3","5.3"
"6320 4 AVENUE","Brooklyn","3144056","11220","307","185","6","191","21","9.1"
"229 65 STREET","Brooklyn","3144132","11220","307","60","0","60","5","12"
"239 SENATOR STREET","Brooklyn","3144456","11220","310","19","3","22","6","3.7"
"6760 4 AVENUE","Brooklyn","3144675","11220","310","52","0","52","4","13"
"465 68 STREET","Brooklyn","3144731","11220","310","76","0","76","6","12.7"
"6717 6 AVENUE","Brooklyn","3144855","11220","310","16","0","16","3","5.3"
"6823 RIDGE BOULEVARD","Brooklyn","3145120","11220","310","128","1","129","20","6.5"
"271 BAY RIDGE AVENUE","Brooklyn","3145156","11220","310","64","0","64","6","10.7"
"6817 3 AVENUE","Brooklyn","3145193","11220","310","92","0","92","8","11.5"
"6814 4 AVENUE","Brooklyn","3145222","11220","310","24","2","26","3","8.7"
"430 68 STREET","Brooklyn","3145264","11220","310","21","0","21","6","3.5"
"444 68 STREET","Brooklyn","3145268","11220","310","36","0","36","6","6"
"452 68 STREET","Brooklyn","3145271","11220","310","25","0","25","6","4.2"
"6823 6 AVENUE","Brooklyn","3145373","11220","310","66","2","68","6","11.3"
"6821 6 AVENUE","Brooklyn","3145374","11220","310","24","0","24","6","4"
"627 BAY RIDGE AVENUE","Brooklyn","3145405","11220","310","112","0","112","4","28"
"6825 7 AVENUE","Brooklyn","3145412","11220","310","9","0","9","3","3"
"6902 RIDGE BOULEVARD","Brooklyn","3145571","11209","310","138","0","138","40","3.5"
"415 OVINGTON AVENUE","Brooklyn","3145771","11209","310","112","2","114","32","3.6"
"560 OVINGTON AVENUE","Brooklyn","3146669","11209","310","22","0","22","6","3.7"
"262 72 STREET","Brooklyn","3147295","11209","310","115","0","115","6","19.2"
"7207 3 AVENUE","Brooklyn","3147330","11209","310","49","0","49","8","6.1"
"302 72 STREET","Brooklyn","3147332","11209","310","55","0","55","7","7.9"
"501 73 STREET","Brooklyn","3147451","11209","310","44","0","44","6","7.3"
"7211 5 AVENUE","Brooklyn","3147455","11209","310","22","4","26","7","3.7"
"7322 5 AVENUE","Brooklyn","3147892","11209","310","23","1","24","6","4"
"634 73 STREET","Brooklyn","3148000","11209","310","94","0","94","6","15.7"
"7923 3 AVENUE","Brooklyn","3150842","11209","310","60","0","60","14","4.3"
"7917 3 AVENUE","Brooklyn","3150844","11209","310","14","0","14","3","4.7"
"575 80 STREET","Brooklyn","3150981","11209","310","47","0","47","9","5.2"
"555 80 STREET","Brooklyn","3150988","11209","310","33","0","33","6","5.5"
"553 80 STREET","Brooklyn","3150989","11209","310","43","0","43","6","7.2"
"278 82 STREET","Brooklyn","3152040","11209","310","74","0","74","10","7.4"
"538 82 STREET","Brooklyn","3152169","11209","310","46","0","46","6","7.7"
"8515 3 AVENUE","Brooklyn","3153100","11209","310","298","0","298","42","7.1"
"367 86 STREET","Brooklyn","3153129","11209","310","53","1","54","6","9"
"313 86 STREET","Brooklyn","3153138","11209","310","105","1","106","30","3.5"
"8501 FT HAMILTON PARKWAY","Brooklyn","3153222","11209","310","290","1","291","51","5.7"
"369 87 STREET","Brooklyn","3153496","11209","310","72","0","72","16","4.5"
"382 90 STREET","Brooklyn","3154569","11209","310","43","0","43","6","7.2"
"351 92 STREET","Brooklyn","3154750","11209","310","62","1","63","20","3.1"
"9216 3 AVENUE","Brooklyn","3155072","11209","310","35","2","37","5","7.4"
"183 GELSTON AVENUE","Brooklyn","3155359","11209","310","99","0","99","31","3.2"
"1243 70 STREET","Brooklyn","3156475","11228","310","9","0","9","3","3"
"1353 70 STREET","Brooklyn","3156521","11228","310","20","0","20","4","5"
"1401 70 STREET","Brooklyn","3156532","11228","311","112","1","113","16","7.1"
"1834 BAY RIDGE AVENUE","Brooklyn","3156744","11204","311","20","0","20","4","5"
"1858 BAY RIDGE AVENUE","Brooklyn","3156751","11204","311","59","0","59","4","14.8"
"1121 71ST STREET","Brooklyn","3157000","11228","310","32","0","32","4","8"
"7006 14 AVENUE","Brooklyn","3157080","11228","310","10","0","10","3","3.3"
"1741 71 STREET","Brooklyn","3157302","11204","311","40","0","40","4","10"
"1105 72 STREET","Brooklyn","3157529","11228","310","48","3","51","6","8.5"
"1433 72 STREET","Brooklyn","3157753","11228","311","32","0","32","6","5.3"
"2171 72 STREET","Brooklyn","3158122","11204","311","15","0","15","4","3.8"
"1757 73 STREET","Brooklyn","3158501","11204","311","9","0","9","3","3"
"1723 73 STREET","Brooklyn","3158512","11204","311","17","1","18","6","3"
"7324 18 AVENUE","Brooklyn","3159057","11204","311","33","0","33","5","6.6"
"7406 13 AVENUE","Brooklyn","3159384","11228","310","47","0","47","3","15.7"
"1663 76 STREET","Brooklyn","3160204","11214","311","69","0","69","6","11.5"
"1863 76 STREET","Brooklyn","3160299","11214","311","27","0","27","4","6.8"
"1824 76 STREET","Brooklyn","3160888","11214","311","13","0","13","4","3.3"
"1407 78 STREET","Brooklyn","3161303","11228","311","134","0","134","19","7.1"
"1754 77 STREET","Brooklyn","3161433","11214","311","15","0","15","4","3.8"
"7701 18 AVENUE","Brooklyn","3161487","11214","311","22","0","22","5","4.4"
"1270 78 STREET","Brooklyn","3161854","11228","310","1","8","9","3","3"
"7803 13 AVENUE","Brooklyn","3161891","11228","310","12","0","12","3","4"
"7812 16 AVENUE","Brooklyn","3162041","11214","311","14","0","14","3","4.7"
"7802 NEW UTRECHT AVENUE","Brooklyn","3162088","11214","311","14","0","14","3","4.7"
"1661 79 STREET","Brooklyn","3162100","11214","311","23","0","23","6","3.8"
"2034 78 STREET","Brooklyn","3162304","11214","311","73","0","73","22","3.3"
"1744 79 STREET","Brooklyn","3162731","11214","311","18","0","18","6","3"
"8128 BAY 16 STREET","Brooklyn","3164591","11214","311","38","0","38","3","12.7"
"8422 13 AVENUE","Brooklyn","3164874","11228","310","19","0","19","5","3.8"
"1675 85 STREET","Brooklyn","3165101","11214","311","20","0","20","4","5"
"2027 85 STREET","Brooklyn","3165408","11214","311","34","0","34","4","8.5"
"1711 BATH AVENUE","Brooklyn","3167640","11214","311","16","0","16","3","5.3"
"150 BAY   22 STREET","Brooklyn","3167814","11214","311","72","8","80","6","13.3"
"2025 BATH AVENUE","Brooklyn","3167880","11214","311","21","0","21","4","5.3"
"1724 BATH AVENUE","Brooklyn","3168566","11214","311","14","1","15","4","3.8"
"1800 BATH AVENUE","Brooklyn","3168634","11214","311","15","0","15","4","3.8"
"8789 19 AVENUE","Brooklyn","3168717","11214","311","13","0","13","3","4.3"
"1904 BATH AVENUE","Brooklyn","3168722","11214","311","19","0","19","4","4.8"
"212 BAY   23 STREET","Brooklyn","3168772","11214","311","10","0","10","3","3.3"
"1963 CROPSEY AVENUE","Brooklyn","3168775","11214","311","10","0","10","3","3.3"
"195 BAY   29 STREET","Brooklyn","3168974","11214","311","101","0","101","14","7.2"
"2150 BATH AVENUE","Brooklyn","3168977","11214","311","15","0","15","5","3"
"909 EAST    5 STREET","Brooklyn","3170343","11230","314","85","0","85","26","3.3"
"2235 63 STREET","Brooklyn","3172174","11204","311","23","0","23","4","5.8"
"2270 64 STREET","Brooklyn","3172251","11204","311","72","0","72","23","3.1"
"6101 23 AVENUE","Brooklyn","3172326","11204","311","48","1","49","6","8.2"
"2328 61 STREET","Brooklyn","3172331","11204","311","13","0","13","3","4.3"
"2420 64 STREET","Brooklyn","3172569","11204","311","26","0","26","6","4.3"
"1523 MC DONALD AVENUE","Brooklyn","3172694","11230","312","25","0","25","4","6.3"
"1013 AVENUE N","Brooklyn","3173155","11230","312","120","0","120","39","3.1"
"1436 WEST    8 STREET","Brooklyn","3173210","11204","311","60","0","60","6","10"
"1315 WEST 7 STREET","Brooklyn","3173363","11204","311","141","1","142","65","2.2"
"1516 WEST   10 STREET","Brooklyn","3174097","11204","311","50","0","50","10","5"
"1650 EAST 2 STREET","Brooklyn","3174719","11230","312","15","0","15","4","3.8"
"1601 DAHILL ROAD","Brooklyn","3175875","11223","311","51","1","52","9","5.8"
"1738 EAST 4 STREET","Brooklyn","3176017","11223","315","25","0","25","6","4.2"
"1724 WEST   13 STREET","Brooklyn","3176340","11223","311","18","0","18","4","4.5"
"1717 WEST    6 STREET","Brooklyn","3176898","11223","311","30","0","30","6","5"
"1718 WEST    3 STREET","Brooklyn","3176953","11223","311","11","0","11","3","3.7"
"1754 WEST    1 STREET","Brooklyn","3177044","11223","311","44","0","44","4","11"
"1769 DAHILL ROAD","Brooklyn","3177135","11223","311","21","0","21","3","7"
"1735 DAHILL ROAD","Brooklyn","3177148","11223","311","22","0","22","6","3.7"
"1713 EAST 8 STREET","Brooklyn","3177558","11223","315","30","0","30","7","4.3"
"802 KINGS HIGHWAY","Brooklyn","3177559","11223","315","84","0","84","39","2.2"
"1875 WEST   13 STREET","Brooklyn","3177743","11223","311","52","0","52","6","8.7"
"1891 WEST   12 STREET","Brooklyn","3177787","11223","311","13","0","13","4","3.3"
"1888 WEST    9 STREET","Brooklyn","3177896","11223","311","52","2","54","17","3.2"
"115 AVENUE S","Brooklyn","3177897","11223","311","113","0","113","17","6.6"
"1884 WEST    6 STREET","Brooklyn","3178093","11223","311","40","0","40","4","10"
"1802 OCEAN PARKWAY","Brooklyn","3178659","11223","315","266","4","270","113","2.4"
"1083 CONEY ISLAND AVENUE","Brooklyn","3178915","11230","314","0","14","14","4","3.5"
"816 EAST   15 STREET","Brooklyn","3179305","11230","314","11","0","11","3","3.7"
"1362 OCEAN AVENUE","Brooklyn","3179459","11230","314","436","1","437","48","9.1"
"977 EAST 12 STREET","Brooklyn","3179534","11230","314","27","0","27","6","4.5"
"953 EAST 15 STREET","Brooklyn","3179682","11230","314","19","0","19","6","3.2"
"1438 OCEAN AVENUE","Brooklyn","3179807","11230","314","102","0","102","51","2"
"1026 EAST   14 STREET","Brooklyn","3179919","11230","314","63","0","63","6","10.5"
"1362 EAST   18 STREET","Brooklyn","3181040","11230","314","36","0","36","4","9"
"1392 EAST   18 STREET","Brooklyn","3181048","11230","314","42","0","42","6","7"
"1857 CONEY ISLAND AVENUE","Brooklyn","3181705","11230","314","39","0","39","6","6.5"
"2057 OCEAN AVENUE","Brooklyn","3182095","11230","314","22","0","22","6","3.7"
"2978 NOSTRAND AVENUE","Brooklyn","3182778","11229","315","21","0","21","5","4.2"
"2984 NOSTRAND AVENUE","Brooklyn","3182781","11229","315","38","0","38","6","6.3"
"1739 EAST 14 STREET","Brooklyn","3182961","11229","315","13","0","13","4","3.3"
"1723 EAST   15 STREET","Brooklyn","3183024","11229","315","40","0","40","12","3.3"
"1711 EAST 15 STREET","Brooklyn","3183027","11229","315","188","2","190","12","15.8"
"1112 AVENUE R","Brooklyn","3183833","11223","315","22","1","23","4","5.8"
"2181 CONEY ISLAND AVENUE","Brooklyn","3183871","11223","315","17","0","17","4","4.3"
"2147 CONEY ISLAND AVENUE","Brooklyn","3183884","11223","315","13","0","13","4","3.3"
"2357 81 STREET","Brooklyn","3185004","11214","311","42","2","44","6","7.3"
"2402 82 STREET","Brooklyn","3185111","11214","311","52","0","52","4","13"
"2310 83 STREET","Brooklyn","3185136","11214","311","59","1","60","4","15"
"2459 85 STREET","Brooklyn","3185272","11214","311","31","1","32","3","10.7"
"2526 85 STREET","Brooklyn","3185391","11214","311","19","0","19","4","4.8"
"8619 23 AVE","Brooklyn","3185411","11214","311","44","0","44","6","7.3"
"2744 W 16 ST","Brooklyn","3188451","11224","313","36","0","36","8","4.5"
"2742 WEST   15 STREET","Brooklyn","3188481","11224","313","30","0","30","8","3.8"
"2767 WEST 15 STREET","Brooklyn","3188504","11224","313","29","1","30","6","5"
"2802 WEST   36 STREET","Brooklyn","3188683","11224","313","33","0","33","6","5.5"
"2820 WEST 36 STREET","Brooklyn","3188686","11224","313","35","0","35","4","8.8"
"2822 WEST   36 STREET","Brooklyn","3188687","11224","313","18","0","18","4","4.5"
"2826 WEST   36 STREET","Brooklyn","3188688","11224","313","14","0","14","4","3.5"
"2844 WEST   36 STREET","Brooklyn","3188694","11224","313","20","0","20","6","3.3"
"2820 WEST   35 STREET","Brooklyn","3188718","11224","313","23","0","23","5","4.6"
"2832 WEST   35 STREET","Brooklyn","3188722","11224","313","21","0","21","4","5.3"
"2842 WEST   35 STREET","Brooklyn","3188725","11224","313","101","0","101","4","25.3"
"2803 MERMAID AVENUE","Brooklyn","3188867","11224","313","33","0","33","7","4.7"
"2807 MERMAID AVENUE","Brooklyn","3188869","11224","313","20","0","20","4","5"
"2830 WEST   19 STREET","Brooklyn","3188995","11224","313","12","0","12","4","3"
"2846 WEST   17 STREET","Brooklyn","3189039","11224","313","35","0","35","4","8.8"
"1607 MERMAID AVENUE","Brooklyn","3189068","11224","313","16","7","23","3","7.7"
"2827 WEST   15 STREET","Brooklyn","3189127","11224","313","21","0","21","5","4.2"
"4035 ATLANTIC AVENUE","Brooklyn","3189295","11224","313","24","0","24","5","4.8"
"1904 MERMAID AVENUE","Brooklyn","3189558","11224","313","38","0","38","3","12.7"
"1718 MERMAID AVENUE","Brooklyn","3189575","11224","313","35","0","35","7","5"
"1412 MERMAID AVENUE","Brooklyn","3189602","11224","313","50","0","50","6","8.3"
"169 AVENUE T","Brooklyn","3190174","11223","311","36","0","36","4","9"
"1942 EAST 8 STREET","Brooklyn","3190528","11223","315","48","0","48","6","8"
"1984 EAST 8 STREET","Brooklyn","3190539","11223","315","16","1","17","4","4.3"
"2151 WEST    5 STREET","Brooklyn","3192620","11223","315","13","0","13","3","4.3"
"320 AVENUE U","Brooklyn","3192671","11223","315","9","0","9","3","3"
"2143 WEST STREET","Brooklyn","3192767","11223","315","18","0","18","4","4.5"
"2115 EAST 1 STREET","Brooklyn","3192817","11223","315","173","0","173","3","57.7"
"420 AVENUE U","Brooklyn","3192866","11223","315","12","0","12","4","3"
"2102 EAST 8 STREET","Brooklyn","3193094","11223","315","15","0","15","4","3.8"
"902 AVENUE U","Brooklyn","3193186","11223","315","16","0","16","4","4"
"2280 EAST 7 STREET","Brooklyn","3193994","11223","315","39","0","39","6","6.5"
"314 AVENUE W","Brooklyn","3194499","11223","315","9","0","9","3","3"
"2314 EAST 1 STREET","Brooklyn","3194557","11223","315","11","0","11","3","3.7"
"14 BOULEVARD COURT","Brooklyn","3194770","11223","315","13","0","13","3","4.3"
"510 AVENUE Y","Brooklyn","3195863","11223","313","9","0","9","3","3"
"367 NEPTUNE AVENUE","Brooklyn","3196332","11235","313","103","8","111","6","18.5"
"277 NEPTUNE AVENUE","Brooklyn","3196384","11235","313","49","0","49","5","9.8"
"283 NEPTUNE AVENUE","Brooklyn","3196387","11235","313","49","0","49","5","9.8"
"225 NEPTUNE AVENUE","Brooklyn","3196431","11235","313","29","0","29","5","5.8"
"193 NEPTUNE AVENUE","Brooklyn","3196511","11235","313","21","0","21","5","4.2"
"717 BRIGHTON    8 COURT","Brooklyn","3196529","11235","313","34","1","35","3","11.7"
"714 BANNER AVENUE","Brooklyn","3196537","11235","313","32","0","32","4","8"
"2079 EAST 26 STREET","Brooklyn","3198712","11229","315","15","0","15","5","3"
"2101 EAST 18 STREET","Brooklyn","3199694","11229","315","13","1","14","4","3.5"
"2622 OCEAN AVENUE","Brooklyn","3199767","11229","315","97","5","102","47","2.2"
"2583 OCEAN AVENUE","Brooklyn","3199831","11229","315","33","0","33","4","8.3"
"1714 AVENUE V","Brooklyn","3200861","11229","315","32","0","32","6","5.3"
"2909 OCEAN AVENUE","Brooklyn","3204413","11235","315","115","1","116","55","2.1"
"2004 GLENWOOD ROAD","Brooklyn","3205715","11210","314","138","0","138","23","6"
"1490 FLATBUSH AVENUE","Brooklyn","3205858","11210","314","25","0","25","4","6.3"
"1003 EAST   37 STREET","Brooklyn","3206171","11210","317","28","0","28","3","9.3"
"848 EAST 28 STREET","Brooklyn","3206389","11210","314","120","0","120","40","3"
"1791 NEW YORK AVENUE","Brooklyn","3207263","11210","318","48","0","48","15","3.2"
"1075 EAST   35 STREET","Brooklyn","3207351","11210","318","173","0","173","16","10.8"
"2458 NOSTRAND AVENUE","Brooklyn","3207878","11210","314","102","0","102","5","20.4"
"2389 NOSTRAND AVENUE","Brooklyn","3207887","11210","318","103","0","103","24","4.3"
"1155 EAST 35 STREET","Brooklyn","3208200","11210","318","106","2","108","38","2.8"
"1479 EAST 34 STREET","Brooklyn","3210501","11234","318","17","0","17","4","4.3"
"1515 EAST 27 STREET","Brooklyn","3211155","11229","315","28","0","28","3","9.3"
"3801 AVENUE P","Brooklyn","3211948","11234","318","25","0","25","3","8.3"
"1115 EAST   58 STREET","Brooklyn","3216841","11234","318","12","0","12","3","4"
"1495 EAST   46 STREET","Brooklyn","3217542","11234","318","115","28","143","8","17.9"
"3842 FLATLANDS AVENUE","Brooklyn","3219247","11234","318","10","0","10","3","3.3"
"2086 FLATBUSH AVENUE","Brooklyn","3219565","11234","318","17","0","17","3","5.7"
"5019 AVENUE N","Brooklyn","3219951","11234","318","9","0","9","3","3"
"1787 EAST   51 STREET","Brooklyn","3220999","11234","318","66","0","66","3","22"
"748 EAST   53 STREET","Brooklyn","3222110","11203","317","96","0","96","3","32"
"644 EAST   89 STREET","Brooklyn","3224089","11236","318","46","0","46","4","11.5"
"1106 REMSEN AVENUE","Brooklyn","3224132","11236","318","106","2","108","17","6.4"
"8410 GLENWOOD ROAD","Brooklyn","3224502","11236","318","73","0","73","3","24.3"
"8111 AVENUE K","Brooklyn","3225584","11236","318","0","9","9","3","3"
"720 EAST 91 STREET","Brooklyn","3228176","11236","317","29","2","31","3","10.3"
"9122 AVENUE B","Brooklyn","3228202","11236","317","11","0","11","3","3.7"
"936 EAST 92 STREET","Brooklyn","3228530","11236","318","37","5","42","4","10.5"
"888 EAST 96 STREET","Brooklyn","3228689","11236","318","151","9","160","32","5"
"903 EAST 95 STREET","Brooklyn","3228697","11236","318","98","7","105","3","35"
"945 EAST 94 STREET","Brooklyn","3228923","11236","318","110","0","110","41","2.7"
"1396 EAST 92 STREET","Brooklyn","3231607","11236","318","96","0","96","3","32"
"10801 SEAVIEW AVENUE","Brooklyn","3233305","11236","318","24","0","24","5","4.8"
"220 BRIGHTON    1 COURT","Brooklyn","3244651","11235","313","6","3","9","3","3"
"3039 BRIGHTON 4 STREET","Brooklyn","3244850","11235","313","119","10","129","8","16.1"
"3029 BRIGHTON    5 STREET","Brooklyn","3244879","11235","313","11","0","11","3","3.7"
"3017 BRIGHTON    5 STREET","Brooklyn","3244883","11235","313","31","15","46","14","3.3"
"3066 BRIGHTON    7 STREET","Brooklyn","3244963","11235","313","0","16","16","3","5.3"
"312 BRIGHTON BEACH AVENUE","Brooklyn","3245071","11235","313","14","0","14","3","4.7"
"3119 CONEY ISLAND AVENUE","Brooklyn","3245306","11235","313","17","0","17","3","5.7"
"1014 OCEAN VIEW AVENUE","Brooklyn","3245309","11235","313","15","0","15","4","3.8"
"105 BRIGHTON 11 STREET","Brooklyn","3245425","11235","313","97","2","99","6","16.5"
"2766 EAST   16 STREET","Brooklyn","3246962","11235","315","22","0","22","6","3.7"
"2826 BRAGG STREET","Brooklyn","3247910","11235","315","9","0","9","3","3"
"99 GRATTAN STREET","Brooklyn","3251794","11237","301","23","0","23","6","3.8"
"407 NEW JERSEY AVENUE","Brooklyn","3252596","11207","305","12","0","12","3","4"
"542 WILLIAMS AVENUE","Brooklyn","3252666","11207","305","22","0","22","6","3.7"
"3338 SHORE PARKWAY","Brooklyn","3255050","11235","315","11","0","11","3","3.7"
"119 QUINCY STREET","Brooklyn","3255180","11216","303","20","1","21","4","5.3"
"184 MILFORD STREET","Brooklyn","3256559","11208","305","34","0","34","3","11.3"
"371 ETNA STREET","Brooklyn","3256588","11208","305","118","0","118","56","2.1"
"644 NEW YORK AVENUE","Brooklyn","3256647","11203","309","9","0","9","3","3"
"646 NEW YORK AVENUE","Brooklyn","3258893","11203","309","15","0","15","3","5"
"945 59 STREET","Brooklyn","3258936","11219","312","23","0","23","4","5.8"
"762 CLASSON AVENUE","Brooklyn","3259312","11238","308","27","0","27","7","3.9"
"5 PULASKI STREET","Brooklyn","3259370","11206","303","17","0","17","3","5.7"
"159 MILTON STREET","Brooklyn","3259442","11222","301","38","0","38","8","4.8"
"1186 NOSTRAND AVENUE","Brooklyn","3259609","11225","309","38","0","38","3","12.7"
"53 HART STREET","Brooklyn","3259664","11206","303","33","0","33","7","4.7"
"65 SOUTH    9 STREET","Brooklyn","3319508","11249","301","13","0","13","3","4.3"
"312 NEW LOTS AVENUE","Brooklyn","3319735","11207","305","40","0","40","13","3.1"
"8809 21 AV","Brooklyn","3320721","11214","311","24","0","24","3","8"
"874 EAST   28 STREET","Brooklyn","3320963","11210","314","19","0","19","6","3.2"
"2729 WEST   16 STREET","Brooklyn","3321187","11224","313","16","0","16","3","5.3"
"249 METROPOLITAN AVENUE","Brooklyn","3321243","11211","301","31","0","31","8","3.9"
"642 DRIGGS AVENUE","Brooklyn","3321245","11211","301","39","0","39","8","4.9"
"1035 MANHATTAN AVENUE","Brooklyn","3321435","11222","301","43","0","43","6","7.2"
"177 HURON STREET","Brooklyn","3321454","11222","301","82","0","82","6","13.7"
"917 MANHATTAN AVENUE","Brooklyn","3321505","11222","301","21","0","21","3","7"
"2828REAR STILLWELL AVENUE","Brooklyn","3321737","11224","313","10","0","10","3","3.3"
"185 KOSCIUSKO STREET","Brooklyn","3322110","11216","303","171","4","175","23","7.6"
"477 GATES AVE","Brooklyn","3322225","11216","303","94","1","95","36","2.6"
"531 GATES AVENUE","Brooklyn","3322232","11216","303","13","0","13","4","3.3"
"529A GATES AVENUE","Brooklyn","3322233","11216","303","29","0","29","4","7.3"
"368 87 STREET","Brooklyn","3322521","11209","310","92","0","92","16","5.8"
"364 87 ST","Brooklyn","3322522","11209","310","61","0","61","16","3.8"
"644A LORIMER STREET","Brooklyn","3322795","11211","301","0","27","27","5","5.4"
"105 EAST   86 STREET","Brooklyn","3323115","11236","317","68","0","68","18","3.8"
"1799 NOSTRAND AVENUE","Brooklyn","3323164","11226","317","89","0","89","5","17.8"
"92 COFFEY STREET","Brooklyn","3323751","11231","306","77","0","77","8","9.6"
"332 ST JOHNS PLACE","Brooklyn","3324413","11238","308","93","0","93","30","3.1"
"1274 PACIFIC STREET","Brooklyn","3324465","11216","308","72","0","72","16","4.5"
"5902 5 AVENUE","Brooklyn","3324491","11220","307","22","0","22","5","4.4"
"99 ALBANY AVENUE","Brooklyn","3324579","11213","308","12","0","12","4","3"
"1165 EASTERN PARKWAY","Brooklyn","3324648","11213","308","81","0","81","16","5.1"
"1159 EASTERN PARKWAY","Brooklyn","3324649","11213","308","146","0","146","16","9.1"
"161 SOUTH    9 STREET","Brooklyn","3324741","11211","301","3","10","13","4","3.3"
"126 LEE AVENUE","Brooklyn","3324751","11211","301","48","0","48","12","4"
"109 NORTH    7 STREET","Brooklyn","3324821","11249","301","49","0","49","8","6.1"
"216 NORTH    8 STREET","Brooklyn","3324843","11211","301","19","1","20","3","6.7"
"986 GREENE AVENUE","Brooklyn","3324999","11221","303","306","3","309","20","15.4"
"982 GREENE AVENUE","Brooklyn","3325000","11221","303","260","0","260","20","13"
"190 WILSON AVENUE","Brooklyn","3325529","11237","304","20","0","20","5","4"
"129 GRAHAM AVENUE","Brooklyn","3325864","11206","301","18","41","59","6","9.8"
"255 BERGEN STREET","Brooklyn","3326008","11217","302","56","8","64","16","4"
"14 JUDGE ST","Brooklyn","3326104","11211","301","23","0","23","7","3.3"
"1573 BUSHWICK AVENUE","Brooklyn","3326365","11207","304","83","0","83","6","13.8"
"390 CHESTER STREET","Brooklyn","3326557","11212","316","17","1","18","3","6"
"330 MILLER AVENUE","Brooklyn","3327011","11207","305","158","1","159","16","9.9"
"1740 NOSTRAND AVENUE","Brooklyn","3327301","11226","317","90","0","90","4","22.5"
"1167 FLATBUSH AVE","Brooklyn","3327303","11226","314","38","0","38","12","3.2"
"1310 FLATBUSH AVENUE","Brooklyn","3327323","11210","314","12","0","12","4","3"
"619 EAST   14 STREET","Brooklyn","3327325","11230","314","60","0","60","16","3.8"
"1204 OCEAN AVENUE","Brooklyn","3327327","11230","314","80","0","80","22","3.6"
"1192 OCEAN AVENUE","Brooklyn","3327328","11230","314","99","0","99","20","5"
"1198 OCEAN AVENUE","Brooklyn","3327329","11230","314","263","1","264","16","16.5"
"5709 13 AVENUE","Brooklyn","3327450","11219","312","9","0","9","3","3"
"5510 13TH   AVE","Brooklyn","3327728","11219","312","84","0","84","19","4.4"
"1476 CONEY ISLAND AVENUE","Brooklyn","3327812","11230","312","45","0","45","5","9"
"182 GRAHAM AVENUE","Brooklyn","3327943","11206","301","37","67","104","4","26"
"791 FLUSHING AVENUE","Brooklyn","3327990","11206","301","65","1","66","6","11"
"171 TROUTMAN STREET","Brooklyn","3328084","11206","304","12","0","12","3","4"
"1265 ROGERS AVENUE","Brooklyn","3328288","11226","317","16","0","16","3","5.3"
"105 16 STREET","Brooklyn","3328472","11215","307","13","0","13","3","4.3"
"105 4 AVENUE","Brooklyn","3330879","11217","306","37","1","38","8","4.8"
"285 EASTERN PARKWAY","Brooklyn","3331283","11238","308","51","0","51","17","3"
"1035 RUTLAND ROAD","Brooklyn","3331870","11212","317","49","2","51","4","12.8"
"558 VERMONT STREET","Brooklyn","3331969","11207","305","18","0","18","4","4.5"
"148 COZINE AVENUE","Brooklyn","3335422","11207","305","23","0","23","4","5.8"
"531 KOSCIUSKO STREET","Brooklyn","3335584","11221","303","11","0","11","3","3.7"
"827 FLATBUSH AVENUE","Brooklyn","3335776","11226","314","26","0","26","3","8.7"
"297 BROADWAY","Brooklyn","3335972","11211","301","12","3","15","4","3.8"
"800 ROGERS AVENUE","Brooklyn","3336214","11226","317","51","0","51","3","17"
"851 ROGERS AVENUE","Brooklyn","3336220","11226","317","23","1","24","5","4.8"
"149 KENILWORTH PLACE","Brooklyn","3336753","11210","314","25","0","25","3","8.3"
"476 47TH STREET","Brooklyn","3337226","11220","307","34","0","34","5","6.8"
"259 4 AVENUE","Brooklyn","3337427","11215","306","3","9","12","4","3"
"2339 PACIFIC STREET","Brooklyn","3337895","11233","316","164","0","164","22","7.5"
"509 HANCOCK STREET","Brooklyn","3338008","11233","303","14","0","14","3","4.7"
"159 SUYDAM STREET","Brooklyn","3338457","11221","304","31","3","34","7","4.9"
"666 FLUSHING AVENUE","Brooklyn","3338542","11206","303","26","1","27","4","6.8"
"1159 BEDFORD AVENUE","Brooklyn","3338694","11216","303","10","0","10","3","3.3"
"2960 WEST   27 STREET","Brooklyn","3339183","11224","313","357","3","360","132","2.7"
"79 EAST   18 STREET","Brooklyn","3339384","11226","314","36","0","36","6","6"
"1236 EAST   82 STREET","Brooklyn","3339728","11236","318","14","0","14","4","3.5"
"678 LAFAYETTE AVENUE","Brooklyn","3340280","11216","303","0","16","16","3","5.3"
"1007 EAST   86 STREET","Brooklyn","3340322","11236","318","13","0","13","3","4.3"
"1005 EAST   86 STREET","Brooklyn","3340323","11236","318","8","1","9","3","3"
"1003 EAST   86 STREET","Brooklyn","3340324","11236","318","19","0","19","3","6.3"
"557 EAST   87 STREET","Brooklyn","3340331","11236","318","17","1","18","4","4.5"
"901 EAST   76 STREET","Brooklyn","3340422","11236","318","24","0","24","6","4"
"911 EAST   76 STREET","Brooklyn","3340424","11236","318","24","0","24","6","4"
"919 EAST   76 STREET","Brooklyn","3340425","11236","318","32","0","32","6","5.3"
"73 TEHAMA STREET","Brooklyn","3340630","11218","312","18","0","18","3","6"
"12425 FLATLANDS AVENUE","Brooklyn","3341452","11208","305","13","0","13","4","3.3"
"8602 AVENUE L","Brooklyn","3341494","11236","318","35","0","35","4","8.8"
"636 11 STREET","Brooklyn","3341661","11215","306","19","0","19","3","6.3"
"348 CUMBERLAND STREET","Brooklyn","3341961","11238","302","0","13","13","3","4.3"
"272 DIVISION AVENUE","Brooklyn","3341990","11211","301","33","0","33","8","4.1"
"120 GROVE STREET","Brooklyn","3342269","11221","304","101","0","101","16","6.3"
"290 SUMPTER STREET","Brooklyn","3342410","11233","316","10","0","10","3","3.3"
"166 SUMPTER STREET","Brooklyn","3342448","11233","303","36","2","38","6","6.3"
"59 DOSCHER STREET","Brooklyn","3342507","11208","305","9","0","9","3","3"
"1105 MADISON STREET","Brooklyn","3342588","11221","304","69","0","69","18","3.8"
"67 DOSCHER STREET","Brooklyn","3342861","11208","305","17","0","17","3","5.7"
"762 ELDERT LANE","Brooklyn","3343250","11208","305","1205","20","1225","294","4.2"
"800 ELDERT LANE","Brooklyn","3343252","11208","305","1306","0","1306","294","4.4"
"780 ELDERT LANE","Brooklyn","3343253","11208","305","1333","11","1344","300","4.5"
"725 LINCOLN AVENUE","Brooklyn","3343255","11208","305","21","1","22","5","4.4"
"735 LINCOLN AVENUE","Brooklyn","3343256","11208","305","1043","14","1057","294","3.6"
"745 LINCOLN AVENUE","Brooklyn","3343257","11208","305","32","0","32","5","6.4"
"755 LINCOLN AVENUE","Brooklyn","3343258","11208","305","31","0","31","6","5.2"
"765 LINCOLN AVENUE","Brooklyn","3343260","11208","305","1929","14","1943","294","6.6"
"168 WEIRFIELD STREET","Brooklyn","3343475","11221","304","15","0","15","4","3.8"
"263 EAST   92 STREET","Brooklyn","3343610","11212","317","117","0","117","4","29.3"
"221 LINDEN BOULEVARD","Brooklyn","3344031","11226","317","275","8","283","72","3.9"
"1499 EAST   46 STREET","Brooklyn","3344586","11234","318","89","11","100","8","12.5"
"336 64 STREET","Brooklyn","3345064","11220","310","13","2","15","4","3.8"
"422 CHESTER STREET","Brooklyn","3345357","11212","316","10","2","12","3","4"
"796 DREW STREET","Brooklyn","3345399","11208","305","32","0","32","4","8"
"1079 EAST   72 STREET","Brooklyn","3345517","11234","318","25","0","25","4","6.3"
"720 EAST  103 STREET","Brooklyn","3345552","11236","318","13","0","13","4","3.3"
"65 EAST   92 STREET","Brooklyn","3346866","11212","317","192","1","193","34","5.7"
"406 EAST   21 STREET","Brooklyn","3347120","11226","314","11","0","11","3","3.7"
"244 SUMPTER STREET","Brooklyn","3347132","11233","316","35","0","35","6","5.8"
"358 SOUTH    3 STREET","Brooklyn","3347321","11211","301","0","9","9","3","3"
"575 GRAND AVENUE","Brooklyn","3347547","11238","308","35","0","35","3","11.7"
"579 GRAND AVENUE","Brooklyn","3347548","11238","308","11","0","11","3","3.7"
"329 18 STREET","Brooklyn","3348053","11215","307","112","0","112","6","18.7"
"236 PULASKI STREET","Brooklyn","3348296","11206","303","52","0","52","8","6.5"
"40 CHRISTOPHER AVENUE","Brooklyn","3348366","11212","316","124","2","126","4","31.5"
"581 GRAND AVENUE","Brooklyn","3348534","11238","308","13","0","13","3","4.3"
"585 GRAND AVENUE","Brooklyn","3348536","11238","308","11","0","11","3","3.7"
"587 GRAND AVENUE","Brooklyn","3348537","11238","308","27","0","27","3","9"
"591 GRAND AVENUE","Brooklyn","3348538","11238","308","24","0","24","6","4"
"593 GRAND AVENUE","Brooklyn","3348539","11238","308","13","0","13","3","4.3"
"463 BELMONT AVENUE","Brooklyn","3348679","11207","305","12","0","12","3","4"
"1064 VERMONT STREET","Brooklyn","3348807","11207","305","13","0","13","4","3.3"
"156 COZINE AVENUE","Brooklyn","3348808","11207","305","27","0","27","4","6.8"
"12161 FLATLANDS AVENUE","Brooklyn","3348814","11207","305","12","0","12","4","3"
"3410 GLENWOOD ROAD","Brooklyn","3349066","11210","317","11","0","11","3","3.7"
"325 SHEPHERD AVENUE","Brooklyn","3350169","11208","305","76","9","85","3","28.3"
"739 DE KALB AVENUE","Brooklyn","3378134","11216","303","26","4","30","8","3.8"
"1520 PACIFIC STREET","Brooklyn","3378301","11213","308","9","0","9","3","3"
"377 SARATOGA AVENUE","Brooklyn","3378382","11233","316","25","0","25","3","8.3"
"1975 PACIFIC STREET","Brooklyn","3378488","11233","308","9","0","9","3","3"
"972 MONTGOMERY STREET","Brooklyn","3379434","11213","309","17","0","17","4","4.3"
"81 VANDERVEER STREET","Brooklyn","3387609","11207","304","21","0","21","3","7"
"774 HERKIMER STREET","Brooklyn","3388039","11233","303","38","3","41","3","13.7"
"972 GATES AVENUE","Brooklyn","3388174","11221","303","12","0","12","3","4"
"713 JEROME STREET","Brooklyn","3388205","11207","305","21","0","21","3","7"
"127 BLAKE AVENUE","Brooklyn","3388271","11212","316","87","1","88","4","22"
"580 NEW JERSEY AVENUE","Brooklyn","3388274","11207","305","100","0","100","3","33.3"
"870 KNICKERBOCKER AVENUE","Brooklyn","3388416","11207","304","35","1","36","3","12"
"848 BELMONT AVENUE","Brooklyn","3388427","11208","305","9","0","9","3","3"
"852 BELMONT AVENUE","Brooklyn","3388429","11208","305","9","0","9","3","3"
"1551 DEAN STREET","Brooklyn","3388499","11213","308","21","0","21","3","7"
"1568A PROSPECT PLACE","Brooklyn","3388822","11233","308","26","0","26","3","8.7"
"1568 PROSPECT PLACE","Brooklyn","3388827","11233","308","10","0","10","3","3.3"
"586 LIBERTY AVENUE","Brooklyn","3388926","11207","305","54","1","55","3","18.3"
"662 NEW YORK AVENUE","Brooklyn","3388972","11203","309","14","1","15","3","5"
"554 60 STREET","Brooklyn","3389001","11220","307","15","0","15","4","3.8"
"14 RADDE PLACE","Brooklyn","3389104","11233","316","21","0","21","3","7"
"2016 STRAUSS STREET","Brooklyn","3389159","11212","316","9","0","9","3","3"
"705 FOUNTAIN AVENUE","Brooklyn","3389191","11208","305","9","0","9","3","3"
"422 AMBER STREET","Brooklyn","3389320","11208","305","11","0","11","3","3.7"
"627 EMERALD STREET","Brooklyn","3389331","11208","305","12","0","12","3","4"
"273 HULL STREET","Brooklyn","3389401","11233","316","21","0","21","3","7"
"816 DUMONT AVENUE","Brooklyn","3389422","11207","305","33","0","33","3","11"
"123 CHESTER STREET","Brooklyn","3389487","11212","316","16","0","16","3","5.3"
"2135 STRAUSS STREET","Brooklyn","3389494","11212","316","8","1","9","3","3"
"108 LIVONIA AVENUE","Brooklyn","3389495","11212","316","19","0","19","3","6.3"
"106 LIVONIA AVENUE","Brooklyn","3389496","11212","316","9","0","9","3","3"
"334 HERZL STREET","Brooklyn","3389499","11212","316","13","0","13","3","4.3"
"264 ESSEX STREET","Brooklyn","3389514","11208","305","14","0","14","3","4.7"
"497 MAPLE STREET","Brooklyn","3389618","11225","309","29","0","29","3","9.7"
"2605 ALBERMARLE ROAD","Brooklyn","3389629","11226","317","36","0","36","3","12"
"2802 ALBEMARLE ROAD","Brooklyn","3389633","11226","317","40","0","40","3","13.3"
"75 EAST   28 STREET","Brooklyn","3389635","11226","317","13","0","13","3","4.3"
"1723 DEAN STREET","Brooklyn","3389877","11213","308","11","1","12","3","4"
"1507 PARK PLACE","Brooklyn","3389911","11213","308","16","0","16","3","5.3"
"173 HULL STREET","Brooklyn","3389996","11233","316","44","0","44","3","14.7"
"329A PULASKI STREET","Brooklyn","3390013","11206","303","9","0","9","3","3"
"978 DE KALB AVENUE","Brooklyn","3390026","11221","303","9","0","9","3","3"
"907 GATES AVENUE","Brooklyn","3390045","11221","303","19","0","19","3","6.3"
"197 CHAUNCEY STREET","Brooklyn","3390058","11233","303","9","0","9","3","3"
"108 MARION STREET","Brooklyn","3390060","11233","303","55","0","55","3","18.3"
"175 MONROE STREET","Brooklyn","3390168","11216","303","11","0","11","3","3.7"
"436 FRANKLIN AVENUE","Brooklyn","3390216","11238","303","12","0","12","3","4"
"71 SUYDAM STREET","Brooklyn","3390270","11221","304","11","0","11","3","3.7"
"136 WOODBINE STREET","Brooklyn","3390319","11221","304","12","0","12","3","4"
"125 ELDERT STREET","Brooklyn","3390372","11207","304","29","1","30","3","10"
"1117 DECATUR STREET","Brooklyn","3390382","11207","304","14","0","14","3","4.7"
"1072 DECATUR STREET","Brooklyn","3390386","11207","304","9","0","9","3","3"
"73 COOPER STREET","Brooklyn","3390390","11207","304","62","1","63","3","21"
"131 WATKINS STREET","Brooklyn","3390437","11212","316","12","0","12","3","4"
"311 SHEFFIELD AVENUE","Brooklyn","3390462","11207","305","10","0","10","3","3.3"
"542 HINSDALE STREET","Brooklyn","3390474","11207","305","36","3","39","3","13"
"2289 PITKIN AVENUE","Brooklyn","3390500","11207","305","31","0","31","3","10.3"
"339 ELTON STREET","Brooklyn","3390509","11208","305","18","0","18","3","6"
"1172 SUTTER AVENUE","Brooklyn","3390602","11208","305","17","0","17","3","5.7"
"2405 ALBEMARLE ROAD","Brooklyn","3390701","11226","317","25","0","25","3","8.3"
"290 CONKLIN AVENUE","Brooklyn","3390745","11236","318","36","0","36","3","12"
"795 FOUNTAIN AVENUE","Brooklyn","3390862","11208","305","23","0","23","3","7.7"
"2517 SNYDER AVENUE","Brooklyn","3390883","11226","317","21","0","21","3","7"
"174 KOSCIUSZKO STREET","Brooklyn","3391029","11216","303","18","0","18","6","3"
"57 CHESTER STREET","Brooklyn","3391057","11212","316","21","0","21","3","7"
"223 MALCOLM X BOULEVARD","Brooklyn","3391227","11221","303","59","0","59","3","19.7"
"227 A MALCOLM X BOULEVARD","Brooklyn","3391329","11221","303","21","3","24","3","8"
"365 ESSEX STREET","Brooklyn","3391363","11208","305","12","1","13","3","4.3"
"916 HOPKINSON AVENUE","Brooklyn","3391442","11212","316","42","0","42","3","14"
"694 LINCOLN AVENUE","Brooklyn","3391633","11208","305","12","0","12","3","4"
"994 NEW YORK AVENUE","Brooklyn","3391657","11203","317","0","9","9","3","3"
"559 BRADFORD STREET","Brooklyn","3391665","11207","305","19","0","19","3","6.3"
"557 BRADFORD STREET","Brooklyn","3391666","11207","305","14","0","14","3","4.7"
"947 HOPKINSON AVENUE","Brooklyn","3391681","11212","316","9","0","9","3","3"
"283 POWELL STREET","Brooklyn","3391690","11212","316","11","0","11","3","3.7"
"356 LOGAN STREET","Brooklyn","3391704","11208","305","19","10","29","3","9.7"
"179 MONROE STREET","Brooklyn","3391831","11216","303","36","1","37","8","4.6"
"99 STOCKTON STREET","Brooklyn","3391838","11206","303","9","0","9","3","3"
"87 STOCKTON STREET","Brooklyn","3391847","11206","303","61","7","68","3","22.7"
"758 LIVONIA AVENUE","Brooklyn","3391894","11207","305","17","0","17","3","5.7"
"580 VAN SICLEN AVENUE","Brooklyn","3391902","11207","305","14","0","14","3","4.7"
"1048 CRESCENT STREET","Brooklyn","3392208","11208","305","9","0","9","3","3"
"147 MANHATTAN AVENUE","Brooklyn","3392631","11206","301","19","0","19","6","3.2"
"124 OSBORN STREET","Brooklyn","3392675","11212","316","15","0","15","3","5"
"427 HERKIMER STREET","Brooklyn","3392773","11213","303","84","0","84","3","28"
"73 CONKLIN AVENUE","Brooklyn","3392788","11236","318","42","0","42","3","14"
"771 DREW STREET","Brooklyn","3392970","11208","305","84","0","84","3","28"
"1355 DECATUR STREET","Brooklyn","3393226","11237","304","33","3","36","3","12"
"323 HOPKINSON AVENUE","Brooklyn","3393268","11233","316","9","0","9","3","3"
"313 HOPKINSON AVENUE","Brooklyn","3393271","11233","316","27","0","27","3","9"
"507 HOWARD AVENUE","Brooklyn","3393519","11233","316","14","0","14","3","4.7"
"19 EAST   51 STREET","Brooklyn","3393782","11203","317","14","0","14","3","4.7"
"353 DE WITT AVENUE","Brooklyn","3393970","11207","305","9","0","9","3","3"
"794A LOGAN STREET","Brooklyn","3394235","11208","305","10","0","10","3","3.3"
"1357 DECATUR STREET","Brooklyn","3396016","11237","304","16","6","22","3","7.3"
"403 ST MARK'S AVENUE","Brooklyn","3396273","11238","308","9","0","9","3","3"
"409 ST MARK'S AVENUE","Brooklyn","3396274","11238","308","51","0","51","3","17"
"401 ST MARK'S AVENUE","Brooklyn","3396276","11238","308","10","0","10","3","3.3"
"411 ST MARK'S AVENUE","Brooklyn","3396277","11238","308","49","0","49","3","16.3"
"92 TROY AVENUE","Brooklyn","3396444","11213","308","12","0","12","3","4"
"174 SKILLMAN AVENUE","Brooklyn","3396783","11211","301","24","0","24","3","8"
"70 CLERMONT AVENUE","Brooklyn","3396813","11205","302","0","10","10","3","3.3"
"146 JEFFERSON STREET","Brooklyn","3396907","11206","304","34","0","34","8","4.3"
"209 EAST   55 STREET","Brooklyn","3397925","11203","317","156","7","163","5","32.6"
"766 HERKIMER STREET","Brooklyn","3398127","11233","303","17","0","17","3","5.7"
"396 LEFFERTS AVENUE","Brooklyn","3398258","11225","309","12","1","13","4","3.3"
"1593 PARK PLACE","Brooklyn","3399222","11233","308","24","0","24","4","6"
"183 CHAUNCEY STREET","Brooklyn","3399513","11233","303","21","0","21","3","7"
"249 CLEVELAND STREET","Brooklyn","3401647","11208","305","10","0","10","3","3.3"
"1124 LORING AVENUE","Brooklyn","3405301","11208","305","11","0","11","3","3.7"
"1465 ST MARKS AVENUE","Brooklyn","3406603","11233","316","9","0","9","3","3"
"1346 MYRTLE AVENUE","Brooklyn","3413707","11221","304","23","0","23","3","7.7"
"343 KNICKERBOCKER AVENUE","Brooklyn","3418132","11237","304","24","0","24","4","6"
"1660 BROADWAY","Brooklyn","3418399","11207","316","25","3","28","3","9.3"
"730 FLATBUSH AVENUE","Brooklyn","3421352","11226","314","81","1","82","6","13.7"
"66 BUFFALO AVENUE","Brooklyn","3421632","11233","308","33","0","33","3","11"
"509 EAST   56 STREET","Brooklyn","3423160","11203","317","43","12","55","3","18.3"
"313 52 STREET","Brooklyn","3424574","11220","307","101","7","108","12","9"
"187 JOHNSON AVENUE","Brooklyn","3424877","11206","301","40","0","40","8","5"
"277 MILFORD STREET","Brooklyn","3426592","11208","305","21","0","21","6","3.5"
"795 FOUNTAIN AVENUE","Brooklyn","3427153","11208","305","23","0","23","3","7.7"
"1742 NOSTRAND AVENUE","Brooklyn","3427282","11226","317","27","0","27","4","6.8"
"1740 NOSTRAND AVENUE","Brooklyn","3427283","11226","317","104","1","105","4","26.3"
"1744 NOSTRAND AVENUE","Brooklyn","3427284","11226","317","33","0","33","4","8.3"
"668 SNEDIKER AVENUE","Brooklyn","3428515","11207","305","13","1","14","3","4.7"
"2077 NOSTRAND AVENUE","Brooklyn","3429713","11210","317","3","9","12","4","3"
"10-32 49 AVENUE","Queens","4000237","11101","402","49","5","54","6","9"
"11-21 47 ROAD","Queens","4000490","11101","402","155","0","155","6","25.8"
"39-88 49 STREET","Queens","4001129","11104","402","166","6","172","75","2.3"
"48-04 SKILLMAN AVENUE","Queens","4001196","11104","402","80","0","80","4","20"
"43-39 42 STREET","Queens","4001945","11104","402","50","1","51","17","3"
"47-19 44 STREET","Queens","4002073","11377","402","18","0","18","6","3"
"45-31 41 STREET","Queens","4002529","11104","402","19","0","19","6","3.2"
"45-55 40 STREET","Queens","4002549","11104","402","19","0","19","6","3.2"
"45-34 40 STREET","Queens","4002605","11104","402","38","0","38","6","6.3"
"45-24 39 PLACE","Queens","4002630","11104","402","37","0","37","10","3.7"
"45-26 39 PLACE","Queens","4002631","11104","402","30","0","30","10","3"
"50-14 41 STREET","Queens","4002959","11104","402","13","0","13","3","4.3"
"34-20 BRADLEY AVENUE","Queens","4003608","11101","402","16","0","16","4","4"
"34-19 9 STREET","Queens","4003853","11106","401","99","1","100","4","25"
"35-31 CRESCENT STREET","Queens","4004009","11106","401","27","0","27","6","4.5"
"35-49 CRESCENT STREET","Queens","4004016","11106","401","36","0","36","6","6"
"36-01 VERNON BOULEVARD","Queens","4004340","11106","401","42","0","42","7","6"
"40-29 23 STREET","Queens","4004934","11101","401","73","1","74","8","9.3"
"13-09 40 AVENUE","Queens","4005321","11101","401","52","0","52","6","8.7"
"11-44 WELLING COURT","Queens","4005530","11102","401","24","0","24","7","3.4"
"31-25 14 STREET","Queens","4005856","11106","401","21","0","21","3","7"
"14-26 30 DRIVE","Queens","4005928","11102","401","32","0","32","5","6.4"
"14-16 30 ROAD","Queens","4005973","11102","401","42","0","42","6","7"
"27-24 21 STREET","Queens","4006095","11102","401","83","6","89","27","3.3"
"14-15 ASTORIA BOULEVARD","Queens","4006111","11102","401","11","0","11","3","3.7"
"23-35 29 AVENUE","Queens","4006216","11102","401","146","12","158","19","8.3"
"23-24 28 AVENUE","Queens","4006222","11102","401","29","0","29","6","4.8"
"34-30 28 STREET","Queens","4007278","11106","401","29","0","29","6","4.8"
"30-42 30 STREET","Queens","4007628","11102","401","36","0","36","8","4.5"
"36-30 31 STREET","Queens","4007874","11106","401","35","1","36","8","4.5"
"36-23 30 STREET","Queens","4007879","11106","401","26","0","26","6","4.3"
"35-23 30 STREET","Queens","4007978","11106","401","11","0","11","3","3.7"
"35-40 31 STREET","Queens","4007993","11106","401","24","0","24","5","4.8"
"35-16 34 STREET","Queens","4008101","11106","401","261","0","261","70","3.7"
"34-34 32 STREET","Queens","4008170","11106","401","14","1","15","4","3.8"
"30-33 31 STREET","Queens","4008480","11102","401","9","0","9","3","3"
"30-16 32 STREET","Queens","4008490","11102","401","9","0","9","3","3"
"25-18 33 STREET","Queens","4008708","11102","401","20","0","20","6","3.3"
"25-27 32 STREET","Queens","4008734","11102","401","15","0","15","5","3"
"31-02 35 STREET","Queens","4008969","11106","401","68","0","68","6","11.3"
"28-52 35 STREET","Queens","4009175","11103","401","62","0","62","6","10.3"
"25-29 34 STREET","Queens","4009353","11103","401","36","0","36","6","6"
"25-92 36 STREET","Queens","4009463","11103","401","14","0","14","3","4.7"
"31-11 35 STREET","Queens","4009796","11106","401","18","0","18","6","3"
"25-70 37 STREET","Queens","4010122","11103","401","58","0","58","16","3.6"
"25-87 38 STREET","Queens","4010240","11103","401","52","3","55","3","18.3"
"25-85 38 STREET","Queens","4010241","11103","401","35","0","35","3","11.7"
"28-34 41 STREET","Queens","4010800","11103","401","10","0","10","3","3.3"
"28-25 41 STREET","Queens","4010816","11103","401","10","0","10","3","3.3"
"34-56 42 STREET","Queens","4010945","11101","401","18","0","18","6","3"
"31-19 41 STREET","Queens","4011186","11103","401","15","0","15","4","3.8"
"30-83 43 STREET","Queens","4011969","11103","401","0","9","9","3","3"
"25-85 43 STREET","Queens","4012230","11103","401","6","4","10","3","3.3"
"34-17 43 STREET","Queens","4012306","11101","401","26","1","27","6","4.5"
"34-01 44 STREET","Queens","4012330","11101","401","89","7","96","48","2"
"32-28 48 STREET","Queens","4013138","11103","401","57","0","57","6","9.5"
"32-40 48 STREET","Queens","4013143","11103","401","19","2","21","6","3.5"
"22-36 41 STREET","Queens","4015391","11105","401","18","0","18","4","4.5"
"40-15 23 AVENUE","Queens","4015406","11105","401","25","2","27","3","9"
"41-20 20 AVENUE","Queens","4015564","11105","401","27","0","27","4","6.8"
"35-19 DITMARS BOULEVARD","Queens","4016611","11105","401","30","0","30","4","7.5"
"22-72 35 STREET","Queens","4017038","11105","401","51","0","51","6","8.5"
"23-81 32 STREET","Queens","4017216","11105","401","0","9","9","3","3"
"24-49 27 STREET","Queens","4017935","11102","401","36","3","39","9","4.3"
"24-35 27 STREET","Queens","4017938","11102","401","20","9","29","9","3.2"
"26-05 24 AVENUE","Queens","4018087","11102","401","21","0","21","6","3.5"
"22-69 27 STREET","Queens","4018162","11105","401","22","0","22","6","3.7"
"25-18 23 AVENUE","Queens","4018755","11105","401","12","0","12","3","4"
"18-21 DITMARS BOULEVARD","Queens","4020339","11105","401","32","0","32","6","5.3"
"25-58 18 STREET","Queens","4020442","11102","401","59","3","62","7","8.9"
"25-45 14 PLACE","Queens","4020448","11102","401","11","0","11","3","3.7"
"4-35 27 AVENUE","Queens","4020653","11102","401","26","0","26","6","4.3"
"24-48 82 STREET","Queens","4022890","11370","403","12","0","12","3","4"
"23-17 93 STREET","Queens","4023672","11369","403","29","0","29","3","9.7"
"80-01 32 AVENUE","Queens","4025822","11370","403","14","0","14","3","4.7"
"32-35 61 STREET","Queens","4026192","11377","401","12","0","12","3","4"
"78-10 32 AVENUE","Queens","4026759","11370","403","19","0","19","3","6.3"
"80-02 32 AVENUE","Queens","4026866","11370","403","18","0","18","3","6"
"34-26 62 STREET","Queens","4027160","11377","402","14","0","14","3","4.7"
"64-17 35 AVENUE","Queens","4027230","11377","402","26","0","26","3","8.7"
"53-17 SKILLMAN AVENUE","Queens","4028433","11377","402","27","0","27","6","4.5"
"40-08 57 STREET","Queens","4028465","11377","402","57","26","83","5","16.6"
"71-10 34 AVENUE","Queens","4028827","11372","403","21","0","21","6","3.5"
"34-14 73 STREET","Queens","4028890","11372","403","9","0","9","3","3"
"34-57 72 STREET","Queens","4028911","11372","403","124","0","124","36","3.4"
"71-11 37 AVENUE","Queens","4029505","11372","403","113","4","117","53","2.2"
"35-23 72 STREET","Queens","4029551","11372","403","18","0","18","6","3"
"37-50 76 STREET","Queens","4029860","11372","403","135","0","135","60","2.3"
"37-54 77 STREET","Queens","4029879","11372","403","28","0","28","6","4.7"
"37-58 79 STREET","Queens","4029938","11372","403","68","1","69","3","23"
"37-02 81 STREET","Queens","4029987","11372","403","311","0","311","39","8"
"39-39 65 STREET","Queens","4030157","11377","402","24","0","24","6","4"
"39-11 65 PLACE","Queens","4030206","11377","402","23","0","23","6","3.8"
"41-31 71 STREET","Queens","4030627","11377","402","33","0","33","3","11"
"41-24 52 STREET","Queens","4030743","11377","402","27","0","27","6","4.5"
"41-02 53 STREET","Queens","4030786","11377","402","130","1","131","7","18.7"
"41-10 53 STREET","Queens","4030789","11377","402","24","0","24","6","4"
"41-26 53 STREET","Queens","4030796","11377","402","33","0","33","6","5.5"
"41-29 53 STREET","Queens","4030809","11377","402","58","0","58","6","9.7"
"58-43 44 AVENUE","Queens","4031347","11377","402","0","9","9","3","3"
"58-44 43 AVENUE","Queens","4031383","11377","402","90","0","90","6","15"
"94-20 ASTORIA BOULEVARD","Queens","4032886","11369","403","149","0","149","38","3.9"
"30-53 82 STREET","Queens","4033091","11370","403","24","0","24","6","4"
"31-30 89 STREET","Queens","4033959","11369","403","9","0","9","3","3"
"33-53 82 STREET","Queens","4035144","11372","403","350","2","352","29","12.1"
"33-17 82 STREET","Queens","4035147","11372","403","53","0","53","11","4.8"
"34-22 92 STREET","Queens","4035718","11372","403","11","0","11","3","3.7"
"83-01 37 AVENUE","Queens","4035828","11372","403","489","9","498","110","4.5"
"35-64 93 STREET","Queens","4036097","11372","403","77","0","77","3","25.7"
"37-37 88 STREET","Queens","4036308","11372","403","151","0","151","60","2.5"
"37-23 89 STREET","Queens","4036343","11372","403","16","0","16","4","4"
"37-24 93 STREET","Queens","4036436","11372","403","7","15","22","3","7.3"
"75-23 BROADWAY","Queens","4036741","11373","404","69","0","69","7","9.9"
"81-38 BAXTER AVENUE","Queens","4037185","11373","404","36","0","36","6","6"
"42-41 KETCHAM STREET","Queens","4037271","11373","404","9","1","10","3","3.3"
"83-40 BRITTON AVENUE","Queens","4037494","11373","404","203","1","204","69","3"
"75-06 WOODSIDE AVENUE","Queens","4037687","11373","404","158","0","158","74","2.1"
"81-02 45 AVENUE","Queens","4038368","11373","404","9","2","11","3","3.7"
"40-26 BENHAM STREET","Queens","4038793","11373","404","112","1","113","3","37.7"
"40-34 ASKE STREET","Queens","4039069","11373","404","15","0","15","3","5"
"42-01 GLEANE STREET","Queens","4039211","11373","404","27","0","27","3","9"
"94-01 40 DRIVE","Queens","4039623","11373","404","14","0","14","3","4.7"
"40-69 JUNCTION BOULEVARD","Queens","4040203","11368","404","34","0","34","4","8.5"
"40-57 JUNCTION BOULEVARD","Queens","4040209","11368","404","84","3","87","4","21.8"
"40-19 99 STREET","Queens","4040293","11368","404","71","0","71","21","3.4"
"97-17 43 AVENUE","Queens","4040456","11368","404","15","0","15","3","5"
"25-19 CURTIS STREET","Queens","4041195","11369","403","11","0","11","3","3.7"
"101-04 32 AVENUE","Queens","4041950","11369","403","15","0","15","5","3"
"107-13 NORTHERN BOULEVARD","Queens","4042211","11368","403","13","1","14","3","4.7"
"33-44 98 STREET","Queens","4042425","11368","403","20","1","21","4","5.3"
"100-13 34 AVENUE","Queens","4042526","11368","403","9","0","9","3","3"
"33-36 102 STREET","Queens","4042555","11368","403","41","0","41","6","6.8"
"105-16 NORTHERN BOULEVARD","Queens","4042688","11368","403","0","18","18","3","6"
"34-13 99 STREET","Queens","4043013","11368","403","21","2","23","3","7.7"
"99-07 37 AVENUE","Queens","4043212","11368","403","33","0","33","3","11"
"35-35 100 STREET","Queens","4043261","11368","403","21","0","21","3","7"
"106-08 34 AVENUE","Queens","4043474","11368","403","28","0","28","6","4.7"
"34-11 107 STREET","Queens","4043564","11368","403","24","0","24","3","8"
"34-05 108 STREET","Queens","4043565","11368","403","55","4","59","6","9.8"
"37-52 104 STREET","Queens","4044305","11368","403","21","0","21","3","7"
"101-14 39 AVENUE","Queens","4044353","11368","403","22","0","22","7","3.1"
"105-04 37 AVENUE","Queens","4044412","11368","403","20","0","20","6","3.3"
"104-32 38 AVENUE","Queens","4044557","11368","403","18","0","18","6","3"
"37-17 108 STREET","Queens","4044688","11368","403","30","9","39","7","5.6"
"108-60 38 AVENUE","Queens","4044766","11368","403","23","0","23","4","5.8"
"108-62 38 AVENUE","Queens","4044767","11368","403","14","0","14","4","3.5"
"108-51 39 AVENUE","Queens","4044788","11368","403","28","0","28","4","7"
"39-06 114 STREET","Queens","4044993","11368","403","220","0","220","70","3.1"
"87-01 51 AVENUE","Queens","4045197","11373","404","129","8","137","4","34.3"
"90-11 53 AVENUE","Queens","4045842","11373","404","26","1","27","3","9"
"54-37 101 STREET","Queens","4047640","11368","404","25","0","25","5","5"
"54-13 101 STREET","Queens","4047646","11368","404","17","0","17","3","5.7"
"104-03 MARTENSE AVENUE","Queens","4047886","11368","404","15","0","15","3","5"
"104-08 MARTENSE AVENUE","Queens","4048120","11368","404","20","2","22","3","7.3"
"57-40 WALDRON STREET","Queens","4048311","11368","404","11","1","12","3","4"
"57-31 108 STREET","Queens","4048357","11368","404","48","0","48","5","9.6"
"40-15 102 STREET","Queens","4048548","11368","404","86","0","86","6","14.3"
"102-14 46 AVENUE","Queens","4048662","11368","404","14","0","14","3","4.7"
"102-43 CORONA AVENUE","Queens","4048752","11368","404","89","0","89","41","2.2"
"104-44 42 AVENUE","Queens","4048859","11368","404","28","0","28","4","7"
"108-39 42 AVENUE","Queens","4049271","11368","404","15","0","15","5","3"
"42-04 111 STREET","Queens","4049310","11368","404","97","0","97","7","13.9"
"43-11 108 STREET","Queens","4049391","11368","404","12","0","12","4","3"
"108-68 45 AVENUE","Queens","4049419","11368","404","11","0","11","3","3.7"
"108-20 48 AVENUE","Queens","4049517","11368","404","200","1","201","6","33.5"
"108-66 48 AVENUE","Queens","4049534","11368","404","23","0","23","3","7.7"
"108-03 51 AVENUE","Queens","4049656","11368","404","21","0","21","5","4.2"
"108-37 52 AVENUE","Queens","4049703","11368","404","20","1","21","3","7"
"102-50 67 ROAD","Queens","4051264","11375","406","9","0","9","3","3"
"62-63 110 STREET","Queens","4051944","11375","406","35","0","35","4","8.8"
"63-69 110 STREET","Queens","4052072","11375","406","27","0","27","4","6.8"
"63-61 110 STREET","Queens","4052074","11375","406","40","0","40","6","6.7"
"75-34 GRAND CENTRL PARKWAY","Queens","4052772","11375","406","18","0","18","3","6"
"75-36 113 PLACE","Queens","4052773","11375","406","11","0","11","3","3.7"
"47-47 46 STREET","Queens","4052871","11377","402","45","0","45","6","7.5"
"46-15 48 AVENUE","Queens","4052879","11377","402","17","0","17","5","3.4"
"46-05 48 AVENUE","Queens","4052883","11377","402","21","2","23","5","4.6"
"45-15 50 AVENUE","Queens","4053043","11377","402","48","0","48","9","5.3"
"51-20 CODWISE PLACE","Queens","4057123","11373","404","36","0","36","3","12"
"53-02 74 STREET","Queens","4058022","11373","405","9","0","9","3","3"
"60-24 54 PLACE","Queens","4059192","11378","405","33","0","33","4","8.3"
"60-58 55 STREET","Queens","4059273","11378","405","83","4","87","4","21.8"
"60-76 55 STREET","Queens","4059278","11378","405","7","2","9","3","3"
"56-30 61 STREET","Queens","4060401","11378","405","220","0","220","5","44"
"60-27 56 DRIVE","Queens","4060411","11378","405","13","0","13","3","4.3"
"72-38 CALDWELL AVENUE","Queens","4063850","11378","405","9","0","9","3","3"
"63-36 WOODHAVEN BOULEVARD","Queens","4069615","11374","405","50","2","52","3","17.3"
"84-53 DANA COURT","Queens","4069616","11379","405","279","43","322","37","8.7"
"73-19 METROPOLITAN AVENUE","Queens","4071501","11379","405","31","0","31","4","7.8"
"65-75 BOOTH STREET","Queens","4072173","11374","406","18","0","18","3","6"
"63-86 WETHEROLE STREET","Queens","4072465","11374","406","0","17","17","3","5.7"
"63-101 ALDERTON STREET","Queens","4072918","11374","406","18","0","18","3","6"
"83-16 LEFFERTS BOULEVARD","Queens","4079393","11415","409","114","0","114","36","3.2"
"118-65 METROPOLITAN AVENUE","Queens","4079514","11415","409","132","1","133","53","2.5"
"81-74 LEFFERTS BOULEVARD","Queens","4079570","11415","409","20","0","20","6","3.3"
"55-40 METROPOLITAN AVENUE","Queens","4080239","11385","405","16","0","16","4","4"
"2207 HARMAN STREET","Queens","4080248","11385","405","62","0","62","12","5.2"
"20-35 HIMROD STREET","Queens","4080468","11385","405","42","0","42","4","10.5"
"502 GRANDVIEW AVE","Queens","4080578","11385","405","14","0","14","3","4.7"
"18-79 TROUTMAN STREET","Queens","4080980","11385","405","18","9","27","6","4.5"
"17-08 STANHOPE STREET","Queens","4081840","11385","405","10","0","10","3","3.3"
"1818 HARMAN STREET","Queens","4081912","11385","405","32","0","32","6","5.3"
"1715 GREENE AVENUE","Queens","4081984","11385","405","38","0","38","6","6.3"
"17-25 MENAHAN STREET","Queens","4082096","11385","405","38","0","38","6","6.3"
"17-21 MENAHAN STREET","Queens","4082098","11385","405","24","0","24","6","4"
"17-11 LINDEN STREET","Queens","4082234","11385","405","42","0","42","9","4.7"
"1686 GATES AVENUE","Queens","4082377","11385","405","23","0","23","6","3.8"
"1673 PALMETTO STREET","Queens","4082387","11385","405","27","1","28","6","4.7"
"1671 PALMETTO STREET","Queens","4082388","11385","405","113","0","113","6","18.8"
"1665 PALMETTO STREET","Queens","4082391","11385","405","19","0","19","6","3.2"
"1662 WOODBINE STREET","Queens","4082412","11385","405","21","0","21","6","3.5"
"16-74 WOODBINE STREET","Queens","4082418","11385","405","32","0","32","6","5.3"
"1682 WOODBINE STREET","Queens","4082422","11385","405","34","0","34","6","5.7"
"17-08 LINDEN STREET","Queens","4082459","11385","405","36","3","39","6","6.5"
"17-14 LINDEN STREET","Queens","4082462","11385","405","78","0","78","6","13"
"686 ONDERDONK AVENUE","Queens","4082554","11385","405","24","2","26","6","4.3"
"17-01 WOODBINE STREET","Queens","4082564","11385","405","59","0","59","16","3.7"
"1708 PALMETTO STREET","Queens","4082568","11385","405","47","0","47","6","7.8"
"1712 PALMETTO STREET","Queens","4082570","11385","405","19","0","19","6","3.2"
"1726 WOODBINE STREET","Queens","4082610","11385","405","108","0","108","6","18"
"1711 MADISON STREET","Queens","4082628","11385","405","29","0","29","6","4.8"
"717 SENECA AVENUE","Queens","4082634","11385","405","20","0","20","6","3.3"
"715 SENECA AVENUE","Queens","4082635","11385","405","16","0","16","3","5.3"
"1820 WOODBINE STREET","Queens","4082673","11385","405","27","1","28","6","4.7"
"18-19 MADISON STREET","Queens","4082686","11385","405","25","0","25","6","4.2"
"17-17 PUTNAM AVENUE","Queens","4082716","11385","405","94","0","94","6","15.7"
"808 SENECA AVENUE","Queens","4082739","11385","405","35","0","35","6","5.8"
"1819 PUTNAM AVENUE","Queens","4082783","11385","405","25","1","26","6","4.3"
"1829 CORNELIA STREET","Queens","4082797","11385","405","50","0","50","6","8.3"
"1823 CORNELIA STREET","Queens","4082800","11385","405","20","0","20","6","3.3"
"1824 CORNELIA STREET","Queens","4082825","11385","405","39","0","39","6","6.5"
"18-64 LINDEN STREET","Queens","4082891","11385","405","23","0","23","3","7.7"
"18-70 PALMETTO STREET","Queens","4082966","11385","405","102","0","102","6","17"
"18-58 WOODBINE STREET","Queens","4082990","11385","405","18","0","18","6","3"
"1874 MADISON STREET","Queens","4083031","11385","405","32","0","32","6","5.3"
"1880 MADISON STREET","Queens","4083034","11385","405","38","0","38","6","6.3"
"788 WOODWARD AVENUE","Queens","4083037","11385","405","18","0","18","4","4.5"
"1872 PUTNAM AVENUE","Queens","4083064","11385","405","21","0","21","6","3.5"
"878 WOODWARD AVENUE","Queens","4083113","11385","405","112","0","112","6","18.7"
"69-20 FOREST AVENUE","Queens","4083180","11385","405","21","3","24","3","8"
"675 WOODWARD AVENUE","Queens","4083246","11385","405","11","1","12","4","3"
"813 WOODWARD AVENUE","Queens","4083353","11385","405","11","2","13","3","4.3"
"851 WOODWARD AVENUE","Queens","4083383","11385","405","13","0","13","4","3.3"
"2055 GATES AVENUE","Queens","4083411","11385","405","41","0","41","6","6.8"
"20-26 GATES AVENUE","Queens","4083426","11385","405","18","0","18","6","3"
"64-07 FOREST AVENUE","Queens","4083667","11385","405","21","0","21","4","5.3"
"59-38 CATALPA AVENUE","Queens","4084061","11385","405","10","0","10","3","3.3"
"60-40 PUTNAM AVENUE","Queens","4084184","11385","405","29","0","29","3","9.7"
"60-47 68 AVENUE","Queens","4084224","11385","405","23","0","23","5","4.6"
"63-09 60 PLACE","Queens","4084539","11385","405","12","0","12","3","4"
"60-62 PALMETTO STREET","Queens","4084881","11385","405","8","2","10","3","3.3"
"60-11 MADISON STREET","Queens","4084951","11385","405","18","0","18","6","3"
"60-88 69 AVENUE","Queens","4085243","11385","405","16","0","16","3","5.3"
"60-91 70 AVENUE","Queens","4085254","11385","405","95","8","103","3","34.3"
"16-34 MADISON STREET","Queens","4085401","11385","405","29","0","29","6","4.8"
"16-45 PUTNAM AVENUE","Queens","4085423","11385","405","20","0","20","6","3.3"
"16-70 PUTNAM AVENUE","Queens","4085455","11385","405","13","0","13","4","3.3"
"1671 CORNELIA STREET","Queens","4085466","11385","405","30","0","30","6","5"
"16-66 JEFFERSON AVENUE","Queens","4085534","11385","405","28","0","28","3","9.3"
"9-03 WYCKOFF AVENUE","Queens","4085566","11385","405","62","0","62","4","15.5"
"10-15 WYCKOFF AVENUE","Queens","4085633","11385","405","24","0","24","6","4"
"16-58 STEPHEN STREET","Queens","4085694","11385","405","15","0","15","4","3.8"
"1648 NORMAN STREET","Queens","4085745","11385","405","18","0","18","5","3.6"
"1052 SENECA AVENUE","Queens","4086027","11385","405","15","0","15","5","3"
"1728 SUMMERFIELD STREET","Queens","4086057","11385","405","45","0","45","4","11.3"
"993 SENECA AVENUE","Queens","4086240","11385","405","39","0","39","5","7.8"
"18-10 CENTRE STREET","Queens","4086250","11385","405","21","0","21","6","3.5"
"18-19 GEORGE STREET","Queens","4086275","11385","405","62","8","70","6","11.7"
"18-10 GEORGE STREET","Queens","4086286","11385","405","59","2","61","6","10.2"
"1818 GEORGE STREET","Queens","4086290","11385","405","24","0","24","6","4"
"75-01 60 LANE","Queens","4086621","11385","405","14","0","14","3","4.7"
"74-25 62 STREET","Queens","4086979","11385","405","15","0","15","3","5"
"74-41 64 LANE","Queens","4087160","11385","405","25","0","25","4","6.3"
"61-14 PALMETTO STREET","Queens","4087679","11385","405","47","0","47","6","7.8"
"61-43 WOODBINE STREET","Queens","4087701","11385","405","51","4","55","8","6.9"
"61-42 MADISON STREET","Queens","4087890","11385","405","25","1","26","8","3.3"
"64-06 MADISON STREET","Queens","4087896","11385","405","57","0","57","6","9.5"
"64-24 MADISON STREET","Queens","4087902","11385","405","41","0","41","6","6.8"
"64-36 MADISON STREET","Queens","4087906","11385","405","24","0","24","6","4"
"69-23 62 STREET","Queens","4088184","11385","405","43","0","43","3","14.3"
"71-17 FRESH POND ROAD","Queens","4088356","11385","405","27","0","27","6","4.5"
"64-09 MYRTLE AVENUE","Queens","4088380","11385","405","13","0","13","4","3.3"
"70-14 66 STREET","Queens","4088484","11385","405","64","0","64","6","10.7"
"70-15 65 PLACE","Queens","4088508","11385","405","51","1","52","6","8.7"
"70-29 66 STREET","Queens","4088613","11385","405","94","1","95","6","15.8"
"70-20 CENTRAL AVENUE","Queens","4089731","11385","405","30","0","30","3","10"
"72-14 69 PLACE","Queens","4090360","11385","405","56","0","56","6","9.3"
"75-12 METROPOLITAN AVENUE","Queens","4091419","11379","405","18","0","18","3","6"
"67-39 75 STREET","Queens","4091487","11379","405","72","4","76","16","4.8"
"69-63 75 STREET","Queens","4092118","11379","405","18","0","18","6","3"
"76-17 MYRTLE AVENUE","Queens","4093281","11385","405","16","0","16","3","5.3"
"79-33 MYRTLE AVENUE","Queens","4093454","11385","405","14","0","14","4","3.5"
"82-03 MYRTLE AVENUE","Queens","4093677","11385","405","32","0","32","3","10.7"
"11-21 COLLEGE POINT BOULEVARD","Queens","4096900","11356","407","28","3","31","3","10.3"
"13-27 COLLEGE POINT BOULEVARD","Queens","4096945","11356","407","22","6","28","4","7"
"116-10 14 ROAD","Queens","4098140","11356","407","208","1","209","6","34.8"
"123-17 18 AVENUE","Queens","4098355","11356","407","25","8","33","6","5.5"
"20-23 COLLEGE POINT BOULEVARD","Queens","4099219","11356","407","20","0","20","3","6.7"
"145-05 21 AVENUE","Queens","4104819","11357","407","19","0","19","4","4.8"
"150-16 14 AVENUE","Queens","4106212","11357","407","20","0","20","4","5"
"140-75 34 AVENUE","Queens","4112565","11354","407","17","0","17","3","5.7"
"35-17 146 STREET","Queens","4113204","11354","407","65","0","65","17","3.8"
"144-41 ROOSEVELT AVENUE","Queens","4113683","11354","407","98","0","98","20","4.9"
"132-30 A MAPLE AVENUE","Queens","4115083","11355","407","15","0","15","3","5"
"140-71 ASH AVENUE","Queens","4117057","11355","407","155","1","156","48","3.3"
"158-17 SANFORD AVENUE","Queens","4120369","11358","407","69","0","69","20","3.5"
"149-64 ELM AVENUE","Queens","4122089","11355","407","28","0","28","3","9.3"
"53-29 196 STREET","Queens","4128021","11365","411","19","0","19","3","6.3"
"134-27 58 AVENUE","Queens","4139201","11355","407","73","0","73","3","24.3"
"153-61 HORACE HARDING EXPRESSWAY","Queens","4141525","11367","407","23","2","25","3","8.3"
"59-46 156 STREET","Queens","4146285","11355","407","12","0","12","3","4"
"59-44 159 STREET","Queens","4146409","11365","407","18","0","18","3","6"
"154-39 64 AVENUE","Queens","4146662","11367","408","34","0","34","4","8.5"
"61-44 164 STREET","Queens","4146984","11365","408","11","0","11","3","3.7"
"61-54 FRESH MEADOW LANE","Queens","4149045","11365","408","35","1","36","5","7.2"
"76-27 85 ROAD","Queens","4181278","11421","409","10","0","10","3","3.3"
"85-49 96 STREET","Queens","4182676","11421","409","114","1","115","16","7.2"
"76-06 JAMAICA AVENUE","Queens","4183071","11421","409","9","0","9","3","3"
"88-44 85 STREET","Queens","4183454","11421","409","21","0","21","4","5.3"
"87-05 89 AVENUE","Queens","4183980","11421","409","73","0","73","20","3.6"
"91-47 88 ROAD","Queens","4184178","11421","409","88","0","88","37","2.4"
"89-18 JAMAICA AVENUE","Queens","4184186","11421","409","23","1","24","4","6"
"74-03 ROCKAWAY BOULEVARD","Queens","4184664","11421","409","31","0","31","3","10.3"
"80-10 95 AVENUE","Queens","4187127","11416","409","19","0","19","3","6.3"
"95-26 92 STREET","Queens","4187538","11416","409","24","0","24","3","8"
"94-26 94 STREET","Queens","4187583","11416","409","20","0","20","3","6.7"
"94-32 94 STREET","Queens","4187586","11416","409","24","0","24","3","8"
"83-07 101 AVENUE","Queens","4188247","11416","409","0","9","9","3","3"
"88-12 97 AVENUE","Queens","4188364","11416","409","35","0","35","3","11.7"
"77-16 101 AVENUE","Queens","4188721","11416","409","37","0","37","5","7.4"
"84-11 103 AVENUE","Queens","4188988","11417","409","23","0","23","3","7.7"
"90-02 LIBERTY AVENUE","Queens","4190793","11417","410","69","0","69","6","11.5"
"92-18 LIBERTY AVENUE","Queens","4190960","11417","410","12","0","12","3","4"
"86-35 98 ST","Queens","4191315","11421","409","12","0","12","4","3"
"86-22 102 STREET","Queens","4191439","11418","409","24","0","24","6","4"
"86-11 101 STREET","Queens","4191450","11418","409","17","0","17","3","5.7"
"113-17 JAMAICA AVENUE","Queens","4192694","11418","409","34","1","35","4","8.8"
"86-40 123 STREET","Queens","4193773","11418","409","18","0","18","6","3"
"86-50 125 STREET","Queens","4193851","11418","409","26","0","26","5","5.2"
"126-11 JAMAICA AVENUE","Queens","4193931","11418","409","9","0","9","3","3"
"87-11 107 STREET","Queens","4194629","11418","409","23","0","23","6","3.8"
"91-10 104 STREET","Queens","4195168","11418","409","9","0","9","3","3"
"110-01 ATLANTIC AVENUE","Queens","4195541","11418","409","23","0","23","3","7.7"
"113-15 ATLANTIC AVENUE","Queens","4195673","11418","409","110","1","111","8","13.9"
"113-13 ATLANTIC AVENUE","Queens","4195674","11418","409","23","3","26","6","4.3"
"115-05 ATLANTIC AVENUE","Queens","4195805","11418","409","20","0","20","3","6.7"
"134-36 JAMAICA AVENUE","Queens","4196420","11418","409","13","0","13","4","3.3"
"91-17 130 STREET","Queens","4196827","11418","409","13","0","13","4","3.3"
"97-51 104 STREET","Queens","4197778","11416","409","29","0","29","8","3.6"
"108-07 101 AVENUE","Queens","4197915","11419","409","23","0","23","5","4.6"
"95-18 114 STREET","Queens","4198132","11419","409","14","0","14","3","4.7"
"113-07 101 AVENUE","Queens","4198154","11419","409","50","0","50","6","8.3"
"113-01 101 AVENUE","Queens","4198157","11419","409","16","0","16","5","3.2"
"94-30 VAN WYCK EXPRESSWAY","Queens","4199463","11419","409","32","0","32","6","5.3"
"117-19 101 AVENUE","Queens","4199563","11419","409","31","0","31","5","6.2"
"119-04 95 AVENUE","Queens","4199599","11419","409","24","1","25","4","6.3"
"121-05 101 AVENUE","Queens","4199767","11419","409","20","1","21","3","7"
"126-10 101 AVENUE","Queens","4200826","11419","409","15","0","15","3","5"
"103-62 103 STREET","Queens","4201360","11417","410","14","0","14","4","3.5"
"106-19 LIBERTY AVENUE","Queens","4201620","11417","410","18","2","20","3","6.7"
"115-11 LIBERTY AVENUE","Queens","4201951","11419","410","24","0","24","4","6"
"107-56 113 STREET","Queens","4203404","11419","410","16","0","16","3","5.3"
"104-15 116 STREET","Queens","4204122","11419","410","4","23","27","6","4.5"
"120-11 109 AVENUE","Queens","4205553","11420","410","92","4","96","36","2.7"
"148-47 88 AVENUE","Queens","4207119","11435","412","9","0","9","3","3"
"141-31 84 DRIVE","Queens","4207759","11435","408","13","0","13","3","4.3"
"88-14 161 STREET","Queens","4208956","11432","412","18","0","18","5","3.6"
"88-50 162 STREET","Queens","4209023","11432","412","37","0","37","4","9.3"
"88-40 163 STREET","Queens","4209034","11432","412","21","0","21","5","4.2"
"88-50 163 STREET","Queens","4209039","11432","412","15","0","15","4","3.8"
"162-19 86 ROAD","Queens","4209197","11432","408","10","3","13","3","4.3"
"89-29 163 STREET","Queens","4209577","11432","412","235","1","236","96","2.5"
"90-38 170 STREET","Queens","4209722","11432","412","430","19","449","41","11"
"88-30 172 STREET","Queens","4209831","11432","412","8","3","11","3","3.7"
"175-27 WEXFORD TERRACE","Queens","4210598","11432","408","137","2","139","66","2.1"
"85-53 164 STREET","Queens","4210634","11432","408","9","0","9","3","3"
"84-72 169 STREET","Queens","4210908","11432","408","17","0","17","3","5.7"
"95-15 BRISBIN STREET","Queens","4214143","11435","412","35","0","35","3","11.7"
"95-30 LIVERPOOL STREET","Queens","4214154","11435","412","23","0","23","3","7.7"
"144-30 106 AVENUE","Queens","4214828","11435","412","18","0","18","3","6"
"106-38 156 STREET","Queens","4215723","11433","412","22","6","28","3","9.3"
"106-43 156 STREET","Queens","4215747","11433","412","47","0","47","4","11.8"
"106-44 NEW YORK BOULEVARD","Queens","4215812","11433","412","13","0","13","3","4.3"
"106-52 GUY R BREWER BOULEVARD","Queens","4215815","11433","412","14","0","14","3","4.7"
"150-24 YATES ROAD","Queens","4215881","11433","412","26","0","26","3","8.7"
"108-14 GUY R BREWER BOULEVARD","Queens","4216184","11433","412","25","0","25","3","8.3"
"163-19 107 AVENUE","Queens","4216293","11433","412","32","0","32","6","5.3"
"104-55 164 STREET","Queens","4216341","11433","412","10","0","10","3","3.3"
"108-42 171 PLACE","Queens","4218561","11433","412","36","2","38","3","12.7"
"114-28 FARMERS BOULEVARD","Queens","4221242","11412","412","19","0","19","5","3.8"
"196-23 POMPEII AVENUE","Queens","4223968","11423","408","9","1","10","3","3.3"
"216-01 HILLSIDE AVENUE","Queens","4228942","11427","413","24","0","24","8","3"
"99-04 A 212 STREET","Queens","4232788","11429","413","54","0","54","5","10.8"
"114-25 FARMERS BOULEVARD","Queens","4236276","11412","412","9","0","9","3","3"
"201-07 LINDEN BOULEVARD","Queens","4238528","11412","412","9","0","9","3","3"
"212-06 99 AVENUE","Queens","4238800","11429","413","18","0","18","4","4.5"
"87-10 PITKIN AVENUE","Queens","4245581","11417","410","17","0","17","4","4.3"
"149-05 88 STREET","Queens","4246654","11414","410","62","0","62","3","20.7"
"151-21 79 STREET","Queens","4246849","11414","410","19","0","19","6","3.2"
"155-40 79 STREET","Queens","4247476","11414","410","54","0","54","3","18"
"106-16 ROCKAWAY BOULEVARD","Queens","4247813","11417","410","11","0","11","3","3.7"
"119-17 111 AVENUE","Queens","4249484","11420","410","119","0","119","42","2.8"
"109-21 LEFFERTS BOULEVARD","Queens","4249499","11420","410","24","0","24","3","8"
"111-07 ROCKAWAY BOULEVARD","Queens","4250165","11420","410","10","1","11","3","3.7"
"111-33 LEFFERTS BOULEVARD","Queens","4250468","11420","410","30","0","30","3","10"
"119-05 ROCKAWAY BOULEVARD","Queens","4251984","11420","410","16","0","16","3","5.3"
"127-07 ROCKAWAY BOULEVARD","Queens","4253004","11420","410","20","0","20","3","6.7"
"132-01 135 AVENUE","Queens","4256245","11420","410","26","0","26","3","8.7"
"127-04 135 AVENUE","Queens","4257343","11420","410","1","13","14","3","4.7"
"145-42 LAKEWOOD AVENUE","Queens","4258025","11435","412","23","0","23","3","7.7"
"108-44 LIVERPOOL STREET","Queens","4258065","11435","412","36","0","36","3","12"
"146-42 LAKEWOOD AVENUE","Queens","4258220","11435","412","33","0","33","5","6.6"
"109-05 LIVERPOOL STREET","Queens","4258288","11435","412","11","0","11","3","3.7"
"113-08 SUTPHIN BOULEVARD","Queens","4258999","11435","412","15","0","15","3","5"
"114-54 SUTPHIN BOULEVARD","Queens","4259579","11434","412","45","3","48","3","16"
"157-03 BRINKERHOFF AVENUE","Queens","4263340","11433","412","21","0","21","3","7"
"115-09 SUTPHIN BOULEVARD","Queens","4264188","11434","412","20","0","20","3","6.7"
"115-47 SUTPHIN BOULEVARD","Queens","4264224","11434","412","24","1","25","3","8.3"
"116-19 SUTPHIN BOULEVARD","Queens","4264633","11434","412","13","0","13","4","3.3"
"116-65 SUTPHIN BOULEVARD","Queens","4264793","11434","412","11","0","11","3","3.7"
"116-59 SUTPHIN BOULEVARD","Queens","4264795","11434","412","15","0","15","3","5"
"121-19 SUTPHIN BOULEVARD","Queens","4265299","11434","412","93","0","93","3","31"
"172-02 LINDEN BOULEVARD","Queens","4268570","11434","412","13","0","13","3","4.3"
"178-20 SELOVER ROAD","Queens","4269973","11434","412","28","0","28","3","9.3"
"216-25 136 ROAD","Queens","4280037","11413","413","29","0","29","3","9.7"
"13-96 BEACH CHANNEL DRIVE","Queens","4297822","11691","414","128","18","146","3","48.7"
"21-31 NAMEOKE AVENUE","Queens","4297823","11691","414","25","0","25","6","4.2"
"11-27 NAMEOKE AVENUE","Queens","4298035","11691","414","79","0","79","17","4.6"
"20 SCOTT A GADELL PLACE","Queens","4298239","11691","414","24","0","24","6","4"
"608 BEACH 19 STREET","Queens","4298333","11691","414","32","0","32","4","8"
"18-14 GATEWAY BOULEVARD","Queens","4298338","11691","414","11","0","11","3","3.7"
"12-03 FRISCO AVENUE","Queens","4299005","11691","414","19","0","19","6","3.2"
"13-51 BEACH CHANNEL DRIVE","Queens","4299521","11691","414","19","0","19","3","6.3"
"13-21 MC BRIDE STREET","Queens","4299613","11691","414","22","0","22","4","5.5"
"13-44 DICKENS STREET","Queens","4299664","11691","414","10","0","10","3","3.3"
"11-36 MC BRIDE STREET","Queens","4300236","11691","414","52","0","52","6","8.7"
"10-26 GIPSON STREET","Queens","4300277","11691","414","10","0","10","3","3.3"
"11-28 DICKENS STREET","Queens","4300323","11691","414","49","0","49","3","16.3"
"24-15 BEACH CHANNEL DRIVE","Queens","4300951","11691","414","20","0","20","5","4"
"318 BEACH   32 STREET","Queens","4301495","11691","414","26","0","26","5","5.2"
"175 BEACH 60 STREET","Queens","4301945","11692","414","25","0","25","3","8.3"
"320 BEACH 67 STREET","Queens","4301997","11692","414","96","16","112","3","37.3"
"342 BEACH 67 STREET","Queens","4301999","11692","414","31","0","31","3","10.3"
"344 BEACH 67 STREET","Queens","4302000","11692","414","34","0","34","4","8.5"
"67-03 BEACH CHANNEL DRIVE","Queens","4302022","11692","414","95","0","95","3","31.7"
"341 BEACH 67 STREET","Queens","4302024","11692","414","19","0","19","3","6.3"
"535 BEACH 66 STREET","Queens","4302667","11692","414","65","0","65","3","21.7"
"519 BEACH 66 STREET","Queens","4302672","11692","414","58","1","59","3","19.7"
"511 BEACH 66 STREET","Queens","4302674","11692","414","20","0","20","3","6.7"
"435 BEACH 66 STREET","Queens","4302836","11692","414","16","0","16","3","5.3"
"431 BEACH 66 STREET","Queens","4302837","11692","414","19","0","19","3","6.3"
"423 BEACH 66 STREET","Queens","4302839","11692","414","19","1","20","3","6.7"
"69-25 GOUVERNEUR AVENUE","Queens","4303155","11692","414","31","1","32","3","10.7"
"70-04 BEACH CHANNEL DRIVE","Queens","4303164","11692","414","2","9","11","3","3.7"
"357 BEACH 70 STREET","Queens","4303311","11692","414","50","0","50","5","10"
"353 BEACH 70 STREET","Queens","4303312","11692","414","16","0","16","4","4"
"110-02 ROCKAWAY BEACH BOULEVARD","Queens","4303749","11694","414","32","0","32","3","10.7"
"117-07 ROCKAWAY BEACH BOULEVARD","Queens","4304800","11694","414","21","4","25","7","3.6"
"127 BEACH 119 STREET","Queens","4304877","11694","414","73","21","94","43","2.2"
"135 BEACH 124 STREET","Queens","4305045","11694","414","96","1","97","3","32.3"
"4-03 BEACH  138 STREET","Queens","4305730","11694","414","10","0","10","3","3.3"
"34-51 106 STREET","Queens","4307625","11368","403","10","0","10","3","3.3"
"55-28 98 STREET","Queens","4307682","11368","404","18","0","18","6","3"
"63-41 110 STREET","Queens","4307890","11375","406","94","0","94","4","23.5"
"63-35 110 STREET","Queens","4307891","11375","406","19","0","19","4","4.8"
"137-28 CENTREVILLE STREET","Queens","4311469","11417","410","45","0","45","3","15"
"74-15 101 AVENUE","Queens","4312469","11416","409","164","0","164","41","4"
"57-48 VAN DOREN STREET","Queens","4314570","11368","404","37","0","37","5","7.4"
"52-84 74 STREET","Queens","4314622","11373","405","25","0","25","3","8.3"
"160-10 75 ROAD","Queens","4314836","11366","408","28","0","28","4","7"
"160-28 75 ROAD","Queens","4314837","11366","408","47","0","47","4","11.8"
"40-50 CASE STREET","Queens","4430212","11373","404","17","0","17","3","5.7"
"44-74 21 STREET","Queens","4430612","11101","402","71","4","75","20","3.8"
"14-24 ASTORIA BOULEVARD","Queens","4430844","11102","401","17","1","18","3","6"
"24-30 29 STREET","Queens","4431085","11102","401","44","0","44","9","4.9"
"24-36 93 STREET","Queens","4431248","11369","403","0","12","12","4","3"
"95-15 NORTHERN BOULEVARD","Queens","4431389","11372","403","87","0","87","14","6.2"
"42-63 HAMPTON STREET","Queens","4431446","11373","404","15","1","16","3","5.3"
"105-26 OTIS AVENUE","Queens","4431833","11368","404","12","0","12","3","4"
"61-06 55 STREET","Queens","4432279","11378","405","92","0","92","4","23"
"70-19 60 LANE","Queens","4434423","11385","405","15","0","15","4","3.8"
"110-02 153 STREET","Queens","4435250","11433","412","32","0","32","3","10.7"
"121-14 FARMERS BOULEVARD","Queens","4435310","11413","412","14","0","14","4","3.5"
"36-14 109 STREET","Queens","4435529","11368","403","14","0","14","4","3.5"
"1-73 BEACH   91 STREET","Queens","4435807","11693","414","21","0","21","6","3.5"
"5-16 BEACH   67 STREET","Queens","4435978","11692","414","30","0","30","3","10"
"410 BEACH   25 STREET","Queens","4436115","11691","414","35","0","35","4","8.8"
"13-83 MC BRIDE STREET","Queens","4436172","11691","414","10","0","10","3","3.3"
"1546 125 STREET","Queens","4436537","11356","407","0","11","11","3","3.7"
"41-46 68 STREET","Queens","4441184","11377","402","18","0","18","4","4.5"
"21-16 35 STREET","Queens","4442351","11105","401","83","1","84","39","2.2"
"21-37 33 STREET","Queens","4442362","11105","401","77","2","79","39","2"
"21-05 33 STREET","Queens","4442363","11105","401","93","0","93","39","2.4"
"57-04 VAN HORN STREET","Queens","4446254","11373","404","27","1","28","3","9.3"
"69-18 38 AVENUE","Queens","4447510","11377","402","10","0","10","3","3.3"
"104-08 150 STREET","Queens","4448147","11435","412","91","0","91","5","18.2"
"75-06 153 STREET","Queens","4448168","11367","408","71","0","71","12","5.9"
"95-17 NORTHERN BOULEVARD","Queens","4449505","11372","403","56","4","60","14","4.3"
"71-15 PARK AVENUE","Queens","4449539","11365","408","22","0","22","3","7.3"
"307 BEACH   66 STREET","Queens","4449712","11692","414","26","0","26","3","8.7"
"311 BEACH   66 STREET","Queens","4449714","11692","414","24","0","24","3","8"
"39-04 112 STREET","Queens","4449872","11368","403","10","0","10","3","3.3"
"90-39 179 PLACE","Queens","4450435","11432","412","36","1","37","10","3.7"
"147-51 72 ROAD","Queens","4451444","11367","408","39","0","39","12","3.3"
"147-07 72 ROAD","Queens","4451448","11367","408","36","1","37","12","3.1"
"147-08 72 ROAD","Queens","4451451","11367","408","51","0","51","12","4.3"
"147-39 73 AVENUE","Queens","4451461","11367","408","60","0","60","11","5.5"
"79-20 149 STREET","Queens","4451487","11367","408","39","0","39","11","3.5"
"150-41 73 AVENUE","Queens","4451514","11367","408","45","0","45","12","3.8"
"150-45 73 AVENUE","Queens","4451515","11367","408","88","0","88","12","7.3"
"150-40 73 AVENUE","Queens","4451522","11367","408","62","0","62","12","5.2"
"71-12 164 STREET","Queens","4451605","11365","408","17","0","17","3","5.7"
"217-19 HILLSIDE AVENUE","Queens","4451913","11427","413","22","0","22","3","7.3"
"211-01 A HILLSIDE AVENUE","Queens","4452602","11427","408","15","0","15","3","5"
"159-07 HILLSIDE AVENUE","Queens","4454854","11432","408","26","0","26","4","6.5"
"14-29 116 STREET","Queens","4454929","11356","407","13","6","19","4","4.8"
"36-03 191 STREET","Queens","4455120","11358","411","30","0","30","4","7.5"
"36-21 191 STREET","Queens","4455123","11358","411","23","0","23","4","5.8"
"36-25 191 STREET","Queens","4455124","11358","411","16","0","16","4","4"
"36-29 191 STREET","Queens","4455126","11358","411","18","0","18","4","4.5"
"191-07 37 AVENUE","Queens","4455127","11358","411","13","0","13","4","3.3"
"191-11 37 AVENUE","Queens","4455128","11358","411","16","0","16","4","4"
"101-68 126 STREET","Queens","4457382","11419","409","45","0","45","3","15"
"172-23 JAMAICA AVENUE","Queens","4457407","11432","412","42","0","42","4","10.5"
"328 BEACH   89 STREET","Queens","4457803","11693","414","12","0","12","4","3"
"87-24 218 STREET","Queens","4458398","11427","413","23","0","23","3","7.7"
"88-49 162 STREET","Queens","4458726","11432","412","15","0","15","3","5"
"22-29 DIX AVENUE","Queens","4458767","11691","414","206","0","206","27","7.6"
"22-37 DIX AVENUE","Queens","4458768","11691","414","100","0","100","26","3.8"
"324 BEACH   66 STREET","Queens","4459154","11692","414","11","0","11","3","3.7"
"88-07 53 AVENUE","Queens","4462714","11373","404","15","0","15","3","5"
"60-55 55 STREET","Queens","4462770","11378","405","12","0","12","3","4"
"37-37 69 STREET","Queens","4462811","11377","402","15","0","15","3","5"
"136-51 35 AVENUE","Queens","4462865","11354","407","0","16","16","3","5.3"
"136-33 35 AVENUE","Queens","4462872","11354","407","6","11","17","3","5.7"
"222 BEACH   29 STREET","Queens","4463449","11691","414","12","0","12","3","4"
"42-31 ELBERTSON STREET","Queens","4463483","11373","404","9","0","9","3","3"
"31-08 SEAGIRT AVENUE","Queens","4463894","11691","414","10","0","10","3","3.3"
"31-10 SEAGIRT AVENUE","Queens","4463895","11691","414","12","0","12","3","4"
"31-16 SEAGIRT AVENUE","Queens","4463897","11691","414","23","0","23","3","7.7"
"94-48 MAGNOLIA COURT","Queens","4518469","11417","410","9","0","9","3","3"
"2-26 BEACH   98 STREET","Queens","4518516","11694","414","12","0","12","3","4"
"102-45 JAMAICA AVENUE","Queens","4525148","11418","409","40","0","40","6","6.7"
"88-20 179 PLACE","Queens","4525899","11432","412","10","0","10","3","3.3"
"28-14 SEAGIRT AVENUE","Queens","4529817","11691","414","12","0","12","3","4"
"228 BEACH   32 STREET","Queens","4529833","11691","414","11","0","11","3","3.7"
"230 BEACH   32 STREET","Queens","4529834","11691","414","11","0","11","3","3.7"
"14-19 BEACH CHANNEL DRIVE","Queens","4530254","11691","414","27","1","28","3","9.3"
"229 BEACH   31 STREET","Queens","4530274","11691","414","24","0","24","3","8"
"142-47 HOR HARDING EXPRESSWAY SR NORT","Queens","4530462","11367","407","41","0","41","3","13.7"
"22-11 119 STREET","Queens","4530865","11356","407","12","0","12","3","4"
"97-58 108 STREET","Queens","4530958","11419","409","9","0","9","3","3"
"101-14 101 AVENUE","Queens","4530964","11416","409","9","0","9","3","3"
"168-47 93 AVENUE","Queens","4530980","11433","412","16","0","16","3","5.3"
"2-15 BEACH   96 STREET","Queens","4531161","11693","414","21","0","21","3","7"
"100-19 41 AVENUE","Queens","4531243","11368","404","10","0","10","3","3.3"
"93-17GAR 197 STREET","Queens","4531347","11423","412","33","0","33","3","11"
"19-11 NEW HAVEN AVENUE","Queens","4531390","11691","414","18","0","18","3","6"
"14-09 CHANDLER STREET","Queens","4531393","11691","414","25","0","25","3","8.3"
"630 GRASSMERE TERRACE","Queens","4531406","11691","414","19","0","19","3","6.3"
"634 GRASSMERE TERRACE","Queens","4531408","11691","414","57","0","57","3","19"
"171 BEACH   60 STREET","Queens","4531443","11692","414","12","0","12","3","4"
"169 BEACH   60 STREET","Queens","4531444","11692","414","16","1","17","3","5.7"
"310 BEACH   86 STREET","Queens","4531449","11693","414","34","0","34","3","11.3"
"95-12GAR VAN WYCK EXPRESSWAY SR WEST","Queens","4531597","11419","409","16","0","16","3","5.3"
"86-20 KINGSTON PLACE","Queens","4531605","11432","408","14","0","14","3","4.7"
"11-21 MC BRIDE STREET","Queens","4531696","11691","414","9","0","9","3","3"
"55-05 98 STREET","Queens","4531798","11368","404","15","0","15","3","5"
"35-36 99 STREET","Queens","4532012","11368","403","21","0","21","7","3"
"116-45 FARMERS BOULEVARD","Queens","4532092","11412","412","13","2","15","3","5"
"116-47 FARMERS BOULEVARD","Queens","4532095","11412","412","12","0","12","3","4"
"86-68 MIDLAND PARKWAY","Queens","4532353","11432","408","52","3","55","3","18.3"
"155-12 107 AVENUE","Queens","4532367","11433","412","10","0","10","3","3.3"
"168-64 93 AVENUE","Queens","4532394","11433","412","28","0","28","4","7"
"157 BEACH   26 STREET","Queens","4532529","11691","414","12","0","12","3","4"
"147 BEACH   26 STREET","Queens","4532531","11691","414","10","0","10","3","3.3"
"149 BEACH   26 STREET","Queens","4532532","11691","414","173","0","173","3","57.7"
"84-84 127 STREET","Queens","4532644","11415","409","19","0","19","3","6.3"
"193-11 LINDEN BOULEVARD","Queens","4532726","11412","412","58","0","58","3","19.3"
"193-07 LINDEN BOULEVARD","Queens","4532727","11412","412","15","0","15","3","5"
"193-13 LINDEN BOULEVARD","Queens","4532728","11412","412","54","0","54","3","18"
"29-47A FAR ROCKAWAY BOULEVARD","Queens","4532783","11691","414","9","0","9","3","3"
"29-23 SEAGIRT AVENUE","Queens","4532784","11691","414","20","0","20","3","6.7"
"189 BEACH   29 STREET","Queens","4532791","11691","414","10","0","10","3","3.3"
"30-06 LEWMAY ROAD","Queens","4532800","11691","414","11","0","11","3","3.7"
"180 BEACH   27 STREET","Queens","4532809","11691","414","9","0","9","3","3"
"141 BEACH   26 STREET","Queens","4532811","11691","414","16","0","16","3","5.3"
"135 BEACH   26 STREET","Queens","4532814","11691","414","25","1","26","3","8.7"
"1-75 BEACH   91 STREET","Queens","4532828","11693","414","21","0","21","3","7"
"22-59 DIX AVENUE","Queens","4532835","11691","414","95","0","95","17","5.6"
"22-51 DIX AVENUE","Queens","4532836","11691","414","136","1","137","30","4.6"
"213 BEACH   28 STREET","Queens","4533123","11691","414","11","0","11","3","3.7"
"203 BEACH   28 STREET","Queens","4533127","11691","414","31","0","31","3","10.3"
"215 BEACH   28 STREET","Queens","4533128","11691","414","27","0","27","3","9"
"41-37 70 STREET","Queens","4533435","11377","402","22","0","22","4","5.5"
"106-05 155 STREET","Queens","4533449","11433","412","16","0","16","3","5.3"
"541 BEACH   19 STREET","Queens","4533456","11691","414","11","0","11","3","3.7"
"94-32 45 AVENUE","Queens","4533475","11373","404","13","0","13","3","4.3"
"11-27 MC BRIDE STREET","Queens","4533592","11691","414","31","0","31","3","10.3"
"84-01 LIBERTY AVENUE","Queens","4533677","11417","409","9","1","10","3","3.3"
"30-10 BROOKHAVEN AVENUE","Queens","4534306","11691","414","30","0","30","3","10"
"311 BEACH   29 STREET","Queens","4534308","11691","414","13","1","14","3","4.7"
"216 BEACH  100 STREET","Queens","4534476","11694","414","10","0","10","3","3.3"
"22-82 NAMEOKE AVENUE","Queens","4534894","11691","414","13","0","13","3","4.3"
"29-41 FAR ROCKAWAY BOULEVARD","Queens","4534931","11691","414","19","0","19","3","6.3"
"13-05A 128 STREET","Queens","4535799","11356","407","12","0","12","3","4"
"92-08 175 STREET","Queens","4536622","11433","412","33","0","33","4","8.3"
"133-60 41 AVENUE","Queens","4536693","11355","407","11","0","11","3","3.7"
"357 BEACH   46 STREET","Queens","4537048","11691","414","25","0","25","3","8.3"
"1886 STARR STREET","Queens","4537062","11385","405","12","0","12","3","4"
"145-35 LIBERTY AVENUE","Queens","4537347","11435","412","9","0","9","3","3"
"91-28 175 STREET","Queens","4537581","11432","412","35","0","35","3","11.7"
"107-38 PRINCETON STREET","Queens","4537605","11435","412","16","0","16","3","5.3"
"81-17 102 ROAD","Queens","4537629","11416","409","67","2","69","3","23"
"108-17 43 AVENUE","Queens","4538185","11368","404","9","0","9","3","3"
"140-32A 34 AVENUE","Queens","4538440","11354","407","11","0","11","3","3.7"
"32-17 58 STREET","Queens","4538668","11377","401","10","0","10","3","3.3"
"91-40 193 STREET","Queens","4539047","11423","412","10","0","10","3","3.3"
"34-15 58 STREET","Queens","4539182","11377","402","9","0","9","3","3"
"109-27 114 STREET","Queens","4539295","11420","410","12","0","12","3","4"
"104-61 39 AVENUE","Queens","4539383","11368","403","53","3","56","4","14"
"81-07 57 AVENUE","Queens","4539537","11373","404","28","1","29","4","7.3"
"27-16 18 STREET","Queens","4547261","11102","401","22","0","22","6","3.7"
"47-28A 59 PLACE","Queens","4548210","11377","402","11","0","11","3","3.7"
"31-37 LINDEN PLACE","Queens","4559498","11354","407","0","9","9","3","3"
"43-12 104 STREET","Queens","4561461","11368","404","27","1","28","7","4"
"27-06 SEAGIRT AVENUE","Queens","4590303","11691","414","34","0","34","3","11.3"
"104-10 150 STREET","Queens","4593846","11435","412","29","0","29","5","5.8"
"80-42 47 AVENUE","Queens","4594146","11373","404","13","0","13","3","4.3"
"86-15 116 STREET","Queens","4594702","11418","409","6","3","9","3","3"
"54-04 102 STREET","Queens","4594998","11368","404","14","1","15","3","5"
"54-06 102 STREET","Queens","4594999","11368","404","15","0","15","3","5"
"54-10 102 STREET","Queens","4595001","11368","404","23","2","25","3","8.3"
"42-05 111 STREET","Queens","4595004","11368","404","9","0","9","3","3"
"92-14 175 STREET","Queens","4595261","11433","412","19","0","19","4","4.8"
"92-10 175 STREET","Queens","4595262","11433","412","52","0","52","4","13"
"92-12 175 STREET","Queens","4599983","11433","412","50","0","50","4","12.5"
"175-14 68 AVENUE","Queens","4605201","11365","408","32","0","32","3","10.7"
"188-27 WOODHULL AVENUE","Queens","4607342","11423","412","20","0","20","3","6.7"
"101-17 37 AVENUE","Queens","4617216","11368","403","10","0","10","3","3.3"
"95-52 112 STREET","Queens","4618574","11419","409","24","0","24","3","8"
"97-16 106 STREET","Queens","4620288","11416","409","9","0","9","3","3"
"440 ST MARKS PLACE","Staten Island","5000212","10301","501","12","0","12","4","3"
"298 ST MARKS PLACE","Staten Island","5000316","10301","501","100","3","103","10","10.3"
"43 CURTIS PLACE","Staten Island","5000634","10301","501","39","3","42","9","4.7"
"28 LAYTON AVENUE","Staten Island","5000899","10301","501","21","0","21","3","7"
"411 JERSEY STREET","Staten Island","5000922","10301","501","48","2","50","5","10"
"369 JERSEY STREET","Staten Island","5000991","10301","501","61","0","61","16","3.8"
"136 HENDRICKS AVENUE","Staten Island","5000997","10301","501","12","0","12","3","4"
"283 A JERSEY STREET","Staten Island","5001042","10301","501","56","0","56","16","3.5"
"336 A JERSEY STREET","Staten Island","5001077","10301","501","94","0","94","14","6.7"
"32 WESTERVELT AVENUE","Staten Island","5001176","10301","501","9","0","9","3","3"
"73 YORK AVENUE","Staten Island","5001216","10301","501","20","0","20","3","6.7"
"216 A JERSEY STREET","Staten Island","5001233","10301","501","73","1","74","20","3.7"
"1 PROSPECT AVENUE","Staten Island","5001253","10301","501","35","0","35","4","8.8"
"514 RICHMOND TERRACE","Staten Island","5001475","10301","501","62","0","62","17","3.6"
"12 CASTLETON AVENUE","Staten Island","5002605","10301","501","25","0","25","4","6.3"
"52 BRITTON STREET","Staten Island","5004904","10310","501","20","0","20","4","5"
"167 MYRTLE AVENUE","Staten Island","5005889","10310","501","27","0","27","4","6.8"
"676 CARY AVENUE","Staten Island","5006049","10310","501","50","0","50","3","16.7"
"661 BAY STREET","Staten Island","5013235","10304","501","45","5","50","4","12.5"
"115 WRIGHT STREET","Staten Island","5013689","10304","501","107","0","107","3","35.7"
"83 THOMPSON STREET","Staten Island","5013752","10304","501","47","0","47","4","11.8"
"87 THOMPSON STREET","Staten Island","5013754","10304","501","16","0","16","4","4"
"660 BAY STREET","Staten Island","5013764","10304","501","15","0","15","4","3.8"
"77 OSGOOD AVENUE","Staten Island","5014286","10304","501","103","0","103","4","25.8"
"207 TARGEE STREET","Staten Island","5014382","10304","501","18","1","19","3","6.3"
"204 GORDON STREET","Staten Island","5014393","10304","501","13","0","13","3","4.3"
"137 HEBERTON AVENUE","Staten Island","5023870","10302","501","120","0","120","28","4.3"
"192 HEBERTON AVENUE","Staten Island","5023964","10302","501","102","1","103","28","3.7"
"945 POST AVENUE","Staten Island","5024075","10302","501","106","0","106","12","8.8"
"244 HOOKER PLACE","Staten Island","5026617","10303","501","72","0","72","4","18"
"180 VAN PELT AVENUE","Staten Island","5027565","10303","501","13","1","14","4","3.5"
"3240 RICHMOND TERRACE","Staten Island","5028394","10303","501","29","0","29","4","7.3"
"3 LAMPED LOOP","Staten Island","5039677","10314","502","12","0","12","3","4"
"50 TOWNSEND AVENUE","Staten Island","5042457","10304","501","31","1","32","10","3.2"
"301 SOUTH AVENUE","Staten Island","5104017","10303","501","25","0","25","8","3.1"
"166 ST MARYS AVENUE","Staten Island","5106203","10305","501","30","0","30","6","5"
"185 PARK HILL AVE","Staten Island","5106233","10304","501","513","0","513","150","3.4"
"225 PARK HILL AVE","Staten Island","5106235","10304","501","556","3","559","151","3.7"
"200 PARKHILL AVENUE","Staten Island","5106238","10304","501","659","12","671","134","5"
"251 BROAD STREET","Staten Island","5106868","10304","501","15","0","15","3","5"
"160 PARKHILL AVE","Staten Island","5109255","10304","501","426","1","427","132","3.2"
"140 PARKHILL AVENUE","Staten Island","5116727","10304","501","409","4","413","132","3.1"
"1924 RICHMOND TERRACE","Staten Island","5151359","10302","501","24","2","26","6","4.3"
"160 ARLO ROAD","Staten Island","5158863","10301","501","12","0","12","4","3"